#############################################
#O  #         #         #   #           #   #
### ##### ### ##### ### # # ##### ##### # # #
# # #     # #     #   #   #       #       # #
# # # ##### ##### ### ####### ############# #
# #   #     #   #   # #       #       #   # #
# ##### ### # # ### # # ####### ##### # # # #
#       #   # #   # # # #     # #   # # #   #
# ### ### ### ### # # ### ### # # ### # #####
# #   # #   # # #   # #   # #   # #   # #   #
# # ### ### # # ##### # ### ##### # ### # # #
# # # #     #   #       #         #   # # # #
### # # ####### # ####### ##### ##### # ### #
#   #     #   # #         # #   #     #   # #
# ######### # # ########### # ### ####### # #
#           # #     #   #   # # #   #   # # #
# ########### ##### # # # # # # ### # ### # #
#       #   # #     # # # #       # #   #   #
# ##### # # # # ##### ### ######### ### ### #
# #   # # #   # #     #       #   #   #   # #
# # # # # ##### ### # # ####### # # # # ### #
# # # # #     #   # #   #       # # # # #   #
### # ####### ### # ##### ####### # # # # ###
#   #         #   #   #   #       # # # # # #
# ######### ### ####### ### ####### # # # # #
# #       # #   #       #   #     # # # #   #
# # ##### ### ##### ##### ### # # # # # ### #
# # #     #   #     #   # #   # # # # # #   #
# # # ##### ### ##### # # ##### # ### # # ###
# # #       #   # #   # #       # #   # # # #
# # ######### ### # ### ######### # ### # # #
#   #         # #   # #         #   #   # # #
# ##### ### ### # ### ######### ##### ### # #
#     #   #   #           #   #   #       # #
##### ####### ######### ### # # # # ####### #
#     #     #   #       #   # # # # #     # #
# ##### ### ### # ####### ### ### # # ### # #
#   #   # #     #   #     #       # # # #   #
### ### # ######### # ############# # # ### #
# #     # #       # #     #   #   #   #   # #
# ####### # ### ### ##### # # # # ##### ### #
# #       # #   #   # #   # #   #       #   #
# # ##### # # ### ### # ### ######### ### ###
#       #   #         #             #      T#
#############################################
