#############################################
#O#             #       #           #       #
# ##### ####### # ##### # ##### ### # ##### #
# #     #     # # #   #   #   #   # # #   # #
# # ##### ### # # ### ##### ##### # # ### # #
# # #   # # #   #   #           # # #     # #
# # ### # # ####### # ######### # ####### # #
# #   #           # # #       # #         # #
# ### # ######### # # # ##### # ########### #
#   # # #   #     # # # #   #           #   #
### # ### # # ##### # # # # ######### ### # #
#   #     # # #     # # # #         # #   # #
# ### ##### ### ##### # # ######### # # #####
#   #     #     #     # # # #       # # #   #
### ### ##### ####### # # # # ####### # # # #
#   #   #   #       # # #   # #       #   # #
# ### ### # ####### ### ##### # ########### #
#   # #   # #     #     #     # #         # #
### ### ### # ########### ### # ##### ### # #
# #   #   # #               # #   #   #   # #
# ### ### # # ########### # ##### # ### ### #
#   # #   # #     #     # #         #   #   #
# # # # ### ####### ### ################# # #
# # #   # #       #   #     #     #       # #
# ####### ####### ### ##### # ### # ####### #
#   #       #   #     #   #   #   #   #     #
# # # ### ### # ######### ##### ##### ##### #
# # # # # #   #           #   #     #     # #
# # # # # # ######### ### # # ##### # ### ###
# #   # #   #     #   #   # #     # #   #   #
# ##### ##### ### # ### ######### # ####### #
#     #         # # # #           #   #     #
##### ######### # # # ########### ### # ### #
#   #   #       # # #         #     #   # # #
# # ### # ######### ##### ##### ######### # #
# #   # #   #       #   # #       #       # #
##### # ### # ####### # # # ####### ##### # #
#     #   # # #       # #     #     #   #   #
# ####### # # # ####### ####### ####### #####
#       # # # #     # # #       #       #   #
# ##### # # # ##### # # # ######### ### ### #
#   #   # # #   #   # #   #   #   # # #   # #
### # ### # # ### ### ##### # # # # # ### # #
#   #       #               #   #   #      T#
#############################################
