+---+---+---+---+---+---+---+---+---+---+---+---+---+---+---+---+---+---+---+---+---+---+
| O     |                   |                   |       |                       |       |
+---+   +---+---+   +---+   +---+---+   +---+   +   +   +---+---+   +---+---+   +   +   +
|   |   |           |   |           |       |       |               |               |   |
+   +   +   +---+---+   +---+---+   +---+   +---+---+---+   +---+---+---+---+---+---+   +
|   |       |           |       |       |   |               |               |       |   |
+   +---+---+   +---+   +   +   +---+   +   +   +---+---+---+   +---+---+   +   +   +   +
|               |       |   |       |   |   |   |           |   |       |   |   |       |
+   +---+   +---+   +---+   +---+   +   +   +---+   +---+   +   +   +---+   +   +---+---+
|   |       |   |       |   |   |       |   |       |   |       |   |       |   |       |
+   +   +---+   +---+   +   +   +---+---+   +   +---+   +---+---+   +   +---+   +   +   +
|   |   |   |           |       |               |                   |       |   |   |   |
+---+   +   +   +---+---+---+   +   +---+---+---+   +---+---+   +---+---+   +   +---+   +
|       |           |       |   |                   |   |       |           |       |   |
+   +---+---+---+---+   +   +   +---+---+---+---+---+   +   +---+   +---+---+---+   +   +
|                       |   |           |       |       |   |   |       |       |   |   |
+   +---+---+---+---+---+   +---+---+   +   +   +   +   +   +   +---+   +   +---+   +   +
|               |       |   |           |   |   |   |               |   |       |       |
+   +---+---+   +   +   +   +   +---+---+   +---+   +---+---+---+---+   +---+   +---+   +
|   |       |   |   |       |   |           |               |       |       |       |   |
+   +   +   +   +   +---+---+   +---+   +   +   +---+---+---+   +   +   +   +   +---+   +
|   |   |   |   |           |       |   |       |               |   |   |   |   |       |
+---+   +   +---+---+---+   +---+   +   +---+---+   +---+---+---+   +   +   +   +   +---+
|       |                   |       |       |       |               |   |   |   |   |   |
+   +---+---+---+---+   +---+   +---+---+---+   +---+   +---+---+---+   +   +   +   +   +
|   |               |   |       |               |       |           |   |   |   |       |
+   +   +---+---+   +---+   +---+---+   +---+---+   +---+   +   +   +   +   +   +---+   +
|   |   |           |       |           |       |   |       |   |   |   |   |   |       |
+   +   +   +---+---+   +---+   +---+---+   +   +   +---+---+   +   +---+   +   +   +---+
|   |   |               |       |   |       |   |               |   |       |   |   |   |
+   +   +---+---+---+---+   +---+   +   +---+   +---+---+---+---+   +   +---+   +   +   +
|       |                   |   |       |   |                   |       |       |   |   |
+   +---+---+   +---+   +---+   +   +---+   +---+---+---+---+   +---+---+   +---+   +   +
|           |       |       |                       |       |       |               |   |
+---+---+   +---+---+---+   +---+---+---+---+   +---+   +   +   +   +   +---+---+---+   +
|           |           |       |               |       |   |   |   |   |           |   |
+   +---+---+   +---+   +---+   +   +---+---+---+   +---+   +---+   +   +   +---+   +   +
|       |       |   |           |       |           |               |   |   |   |       |
+---+   +---+   +   +---+---+---+---+   +   +---+---+---+---+---+---+   +   +   +---+   +
|   |           |   |               |   |           |       |       |       |       |   |
+   +---+---+---+   +   +---+   +---+   +---+---+   +   +   +   +   +---+---+   +---+   +
|   |               |   |       |       |   |       |   |       |               |       |
+   +   +---+---+   +   +   +---+   +---+   +   +---+   +---+---+---+---+   +---+   +---+
|               |       |                   |                           |             T |
+---+---+---+---+---+---+---+---+---+---+---+---+---+---+---+---+---+---+---+---+---+---+
