+---+---+---+---+---+---+---+---+---+---+---+---+---+---+---+---+---+---+---+---+---+---+
| O |                           |               |                       |               |
+   +---+---+   +---+---+---+   +   +---+---+   +   +---+---+   +---+   +   +---+---+   +
|   |           |           |   |   |       |       |       |       |   |   |       |   |
+   +   +---+---+   +---+   +   +   +---+   +---+---+   +---+---+   +   +   +---+   +   +
|   |   |       |   |   |       |       |                       |   |   |           |   |
+   +   +---+   +   +   +---+---+---+   +   +---+---+---+---+   +   +---+---+---+   +   +
|   |       |                       |   |   |               |   |                   |   |
+   +---+   +   +---+---+---+---+   +   +   +   +---+---+   +   +---+---+---+---+---+   +
|       |   |   |       |           |   |   |   |       |                       |       |
+---+   +   +---+   +   +   +---+---+   +   +   +   +   +---+---+---+---+   +---+   +   +
|       |           |   |   |           |   |   |   |                   |   |       |   |
+   +---+   +---+---+   +---+   +---+---+   +   +   +---+---+---+---+   +   +   +---+---+
|       |           |           |           |   |   |   |               |   |   |       |
+---+   +---+   +---+---+   +---+---+---+   +   +   +   +   +---+---+---+   +   +   +   +
|       |       |       |               |   |   |       |   |               |       |   |
+   +---+   +---+   +   +---+---+---+   +---+   +---+---+   +   +---+---+---+---+---+   +
|       |   |       |   |           |           |           |   |                   |   |
+---+   +---+   +---+   +   +---+---+---+---+---+   +---+   +   +---+---+   +---+   +   +
|   |       |       |   |                               |   |       |       |       |   |
+   +---+   +---+   +   +   +---+---+---+---+---+   +   +---+---+   +   +---+   +---+   +
|       |   |       |   |           |           |   |                   |       |       |
+   +   +   +   +---+   +---+---+---+   +---+   +---+---+---+---+---+---+---+---+   +   +
|   |   |       |   |               |       |           |           |               |   |
+   +---+---+---+   +---+---+---+   +---+   +---+---+   +   +---+   +   +---+---+---+   +
|       |               |       |           |       |       |       |       |           |
+   +   +   +---+   +---+   +   +---+---+---+---+   +---+---+   +---+---+   +---+---+   +
|   |   |   |   |   |       |                       |       |           |           |   |
+   +   +   +   +   +   +---+---+---+---+   +---+   +   +   +---+---+   +   +---+   +---+
|   |       |   |       |           |       |       |   |           |   |       |       |
+   +---+---+   +---+---+   +---+   +   +---+   +---+---+---+---+   +   +---+---+---+   +
|           |                   |   |   |   |                       |       |           |
+---+---+   +---+---+---+---+   +   +   +   +---+---+---+---+---+   +---+   +   +---+   +
|       |       |               |   |   |                   |           |       |   |   |
+   +   +---+   +   +---+---+---+---+   +---+---+   +---+---+   +---+---+---+---+   +   +
|   |       |   |       |               |       |   |               |               |   |
+---+---+   +   +---+   +   +---+---+---+   +   +   +   +---+---+---+   +---+---+   +   +
|           |       |   |   |               |   |           |           |       |       |
+   +---+---+---+   +   +   +   +---+---+---+   +---+---+---+   +---+---+---+   +---+---+
|               |   |   |   |           |   |   |               |               |       |
+   +---+---+   +   +   +   +---+---+   +   +   +   +---+---+---+---+   +---+   +---+   +
|       |       |   |   |       |       |   |       |       |       |   |   |       |   |
+---+   +   +---+   +   +   +---+   +---+   +---+---+   +   +   +   +   +   +---+   +   +
|       |               |                               |       |       |             T |
+---+---+---+---+---+---+---+---+---+---+---+---+---+---+---+---+---+---+---+---+---+---+
