#############################################
#O  #         #       #       #       #     #
### # ####### # # ##### ##### # # ### ##### #
#   #     # # # #           #   # #   #     #
# ####### # # ### ############# # # ### ### #
# #       # #   #     #   #   # # # #   #   #
# # ####### ### ##### # # # # ### # # ### ###
#   #         #   #   # # # #   # #   # #   #
##### ##### ##### # ### # # ### # ##### ### #
# #     #   #     # #   #   # #   #       # #
# # ### # ### ####### ####### ####### ##### #
# # #   #   # #       #               #     #
# # # ####### # ####### ### ########### #####
#   #       # #   #   #   # #         #   # #
# ######### # # # # ##### # # ####### ### # #
#       # #   # # #       #   # #     # #   #
####### # ####### # ########### # ### # ### #
#       #         #             #   #     # #
# ########### # ############# ##### ####### #
# #         # #   #     # #   #     #     # #
# # ### ### ### # # ### # # ### ### # ### # #
# # #   # #   # # # #   # # #   # # # # #   #
# ### ### ### # # # ### # # # ### # # # #####
#     #   # # # # #   # #   #   #   # #     #
####### # # # # # # # # ### ### ##### ##### #
#       #   # # # # # #   #   #     #     # #
##### ##### # # # ### ### ######### ##### # #
#   # #     # # #   #   #       #   #   # # #
# # # ### ### ##### ### ####### # # ### # # #
# # #   #   # #     #   #   #   # #     # # #
# # ### ### # # ##### ### ### ### ##### # # #
# #     #   # #   # #   #     #   # #   #   #
# ########### ### # # # ##### ### # # ##### #
# #           #   #   # #   #     #   #   # #
# # ########### ### ### # # ####### ### # # #
# #   #         # # # #   # #     #     # # #
# ### ##### ### # # # ##### ### ### ####### #
#   #     # #   # #   #   #   #     #       #
# # ##### ### ### ### ### ### ### ### #######
# #   #   #   #     # #     #   #   #       #
# ### # ### ### # ### # ### ### ########### #
# # #   #   #   # #   #   #   # #       #   #
# # ##### ### ##### ##### ### # # # ##### ###
#         #               #   #   #        T#
#############################################
