+-+-+-+-+-+-+
|S  |       |
+-+ +-+-+-+ +
| |     |   |
+ +-+-+ + + +
|   |   | | |
+ + + +-+ +-+
| |   |     |
+ +-+-+ +-+ +
| |   | |   |
+ + + +-+ + +
|   |     |E|
+-+-+-+-+-+-+
