#############
#S  #       #
### ####### #
# #     #   #
# ##### # # #
#   #   # # #
# # # ### ###
# #   #     #
# ##### ### #
# #   # #   #
# # # ### # #
#   #     #E#
#############
