+-+-+-+-+-+-+
|S|         |
+ +-+-+ +-+ +
|   |   |   |
+-+ + +-+ +-+
|   | | |   |
+ +-+ + +-+ +
| |   |   | |
+ +-+ + +-+ +
|     |     |
+-+-+-+ +-+-+
|          E|
+-+-+-+-+-+-+
