#############
#S#         #
# ##### ### #
#   #   #   #
### # ### ###
#   # # #   #
# ### # ### #
# #   #   # #
# ### # ### #
#     #     #
####### #####
#          E#
#############
