#############
#S#         #
# ##### ### #
# #     #   #
# # ##### ###
# # #   # # #
# # # # # # #
#   # # # # #
##### # # # #
#   # # #   #
# # # # ### #
# #   #    E#
#############
