#############
#S      #   #
####### # # #
#     #   # #
# # ####### #
# #       # #
# ####### # #
#     #   # #
##### # ### #
# #   #   # #
# # ##### # #
#       #  E#
#############
