+---+---+---+---+---+---+---+---+---+---+---+---+---+---+---+---+---+---+
| O     |                   |       |               |               |   |
+---+   +   +---+---+---+   +---+   +   +---+   +   +---+   +   +   +   +
|   |       |           |       |       |       |       |   |   |       |
+   +---+---+---+---+   +---+   +---+   +   +---+---+   +---+   +---+---+
|   |                   |   |       |   |   |   |       |       |       |
+   +   +---+   +---+   +   +---+   +---+   +   +   +---+   +---+   +   +
|       |       |       |       |           |   |       |           |   |
+   +---+   +---+   +---+   +---+---+---+---+   +---+   +---+---+---+   +
|   |       |       |       |                       |               |   |
+   +   +---+   +---+---+   +   +   +---+---+---+---+---+---+---+   +   +
|   |   |   |               |   |               |               |   |   |
+   +   +   +---+---+---+   +   +---+---+---+   +   +---+---+   +   +   +
|   |   |   |               |               |   |       |   |       |   |
+---+   +   +   +---+---+---+---+   +---+---+   +---+   +   +---+---+   +
|       |       |               |   |           |   |   |           |   |
+   +---+---+   +   +---+---+   +   +   +---+   +   +   +---+   +   +   +
|   |       |   |           |       |       |       |       |   |       |
+   +   +   +---+---+---+   +---+---+---+   +---+---+---+   +   +---+   +
|   |   |                   |           |       |       |       |   |   |
+   +   +---+---+---+---+---+   +   +---+---+   +   +   +---+---+   +   +
|   |   |           |           |           |       |               |   |
+   +   +---+   +   +---+   +---+---+   +   +---+---+---+---+---+   +   +
|   |           |       |   |       |   |       |       |       |   |   |
+   +---+---+---+---+   +---+   +   +   +---+   +   +---+   +   +   +   +
|           |       |           |       |   |       |       |       |   |
+   +---+---+   +   +---+---+---+---+---+   +---+   +   +---+---+---+   +
|       |       |               |               |   |   |       |       |
+   +   +   +---+---+   +   +---+   +   +---+   +   +   +   +   +   +---+
|   |   |       |       |   |       |       |   |   |       |       |   |
+   +   +   +---+   +---+   +   +---+---+   +---+   +---+---+---+---+   +
|   |   |   |       |       |       |   |           |       |           |
+   +   +   +   +---+---+---+---+   +   +---+---+---+   +   +---+---+   +
|   |   |   |   |       |       |   |               |   |               |
+   +   +   +   +   +   +   +   +   +---+---+   +   +   +---+---+---+   +
|   |       |       |       |                   |       |             T |
+---+---+---+---+---+---+---+---+---+---+---+---+---+---+---+---+---+---+
