+---+---+---+---+---+---+---+---+---+---+---+---+---+---+---+---+---+---+
| O     |       |       |       |           |       |       |           |
+---+   +   +   +   +   +   +   +---+---+   +   +   +   +   +   +---+   +
|   |   |   |       |       |       |       |   |       |       |       |
+   +   +   +---+   +---+---+---+   +   +---+   +---+---+---+---+   +---+
|       |       |   |           |       |       |               |       |
+   +---+   +   +---+   +---+   +---+---+   +---+---+---+   +   +---+   +
|   |       |           |   |               |           |   |   |       |
+   +   +---+---+---+---+   +---+---+---+---+---+   +   +   +---+   +   +
|   |   |                                   |       |       |       |   |
+   +   +---+---+   +   +---+---+---+---+   +   +---+---+   +   +---+   +
|   |       |       |   |               |       |           |   |       |
+   +---+   +   +---+---+   +---+---+   +   +---+---+---+---+   +   +---+
|   |   |   |               |           |   |           |       |   |   |
+   +   +   +   +---+---+---+   +---+---+   +   +---+   +   +---+   +   +
|   |       |       |       |   |       |   |       |   |       |   |   |
+   +   +---+---+---+   +   +   +   +   +   +---+   +   +   +   +   +   +
|   |                   |   |   |   |   |       |   |   |   |   |       |
+   +---+---+---+---+---+   +   +   +---+---+   +   +   +---+   +---+   +
|       |   |           |       |               |   |       |   |       |
+---+   +   +   +---+   +   +---+---+---+---+   +   +---+   +   +---+   +
|   |   |   |       |       |       |       |   |   |   |   |       |   |
+   +   +   +---+   +---+---+   +   +   +   +---+   +   +   +   +   +   +
|       |   |       |   |       |       |           |   |   |   |   |   |
+   +---+   +   +---+   +   +---+---+---+---+---+---+   +   +---+   +---+
|   |       |           |                       |       |       |       |
+   +   +   +---+---+   +---+---+---+---+---+   +   +   +---+   +---+   +
|   |   |   |           |                       |   |       |   |       |
+   +   +   +   +---+---+   +   +---+---+---+---+   +---+---+   +   +---+
|   |   |       |       |   |   |       |       |   |           |       |
+   +   +---+---+---+   +   +---+   +   +   +   +   +   +---+---+---+   +
|   |           |       |           |       |   |       |               |
+   +---+---+   +   +---+---+---+---+---+---+   +   +---+   +---+---+   +
|       |           |       |                   |           |           |
+---+   +---+---+---+   +   +   +---+---+---+---+---+---+---+   +---+---+
|                       |       |                                     T |
+---+---+---+---+---+---+---+---+---+---+---+---+---+---+---+---+---+---+
