#####################################
#O  #         #   #       #       # #
### # ####### ### # ### # ### # # # #
# #   #     #   #   #   #   # # #   #
# ######### ### ### # ##### ### #####
# #         # #   # # # #   #   #   #
# # ### ### # ### ### # # ### ### # #
#   #   #   #   #     # #   #     # #
# ### ### ### ######### ### ####### #
# #   #   #   #           #       # #
# # ### ##### # # ############### # #
# # # #       # #       #       # # #
# # # ####### # ####### # ##### # # #
# # # #       #       # #   # #   # #
### # # ######### ##### ### # ##### #
#   #   #       # #     # # #     # #
# ##### # ##### # # ### # # ### # # #
# #   # #     #   #   #   #   # #   #
# # # ####### ####### ####### # ### #
# # #         #     #   #   #   # # #
# # ########### # ##### # # ##### # #
# # #     #     #     #   #       # #
# # ### # ### ##### # ########### # #
# #     #   # #   # #   #   #   # # #
# ######### ### # # ### # ### # # # #
#     #   #     #   # #   #   #   # #
# ##### # ########### ### # ####### #
#   #   #       #       # # #   #   #
# # # ##### # ### # ### # # # # # ###
# # #   #   # #   #   # # #   #   # #
# # # ### ### # ##### ### ######### #
# # # #   #   #   # #     #   #     #
# # # # ######### # ####### # ##### #
# # # # #   #   # #       # #       #
# # # # # # # # # ##### # # ####### #
# #   #   #   #         #   #      T#
#####################################
