+---+---+---+---+---+---+---+---+---+---+---+---+---+---+---+---+---+---+
| O         |               |                           |               |
+---+---+   +---+   +---+   +---+---+---+---+   +---+   +   +   +---+---+
|       |       |   |   |               |       |       |   |   |       |
+   +---+---+   +   +   +---+---+---+   +   +---+---+   +   +   +   +   +
|           |       |                   |   |       |   |   |       |   |
+   +---+   +---+---+   +---+---+---+---+   +   +   +---+   +---+---+   +
|   |               |       |           |       |           |           |
+   +   +---+---+---+---+   +   +---+   +   +---+---+---+---+   +---+   +
|   |               |       |   |       |       |           |       |   |
+   +---+---+---+   +   +---+   +   +---+---+   +   +---+   +---+   +---+
|       |           |   |       |   |           |   |           |       |
+   +---+   +---+   +   +---+   +---+   +---+---+---+   +---+   +---+   +
|   |       |       |       |       |   |           |       |       |   |
+   +   +   +---+---+---+   +   +   +   +---+   +   +---+   +---+---+   +
|   |   |   |       |       |   |       |       |       |   |           |
+---+   +---+   +   +   +---+   +---+---+   +---+---+   +   +   +---+   +
|       |       |       |   |   |           |       |       |   |       |
+   +   +   +---+---+---+   +   +   +---+---+   +---+---+   +   +---+---+
|   |   |   |               |   |           |               |           |
+   +   +   +---+   +   +---+   +   +---+   +   +---+---+---+---+---+   +
|   |   |       |   |           |   |       |           |           |   |
+   +---+---+   +   +---+---+---+---+   +---+---+---+   +   +---+   +   +
|           |   |   |                   |               |       |   |   |
+   +---+   +   +   +---+---+   +---+---+---+---+   +---+---+   +   +   +
|   |       |   |           |   |               |               |   |   |
+---+   +   +   +---+---+   +   +   +---+---+   +---+---+---+   +---+   +
|       |   |       |       |   |       |   |       |           |       |
+   +---+   +---+   +---+   +   +---+   +   +---+   +---+---+---+   +   +
|   |           |       |           |   |       |               |   |   |
+   +---+---+---+---+   +---+---+   +   +---+   +---+---+---+   +   +   +
|   |                   |           |   |       |               |   |   |
+   +   +---+---+---+---+---+---+---+   +   +---+   +---+---+---+   +   +
|   |   |           |                   |   |       |               |   |
+   +   +---+   +   +---+   +---+---+---+   +   +---+---+   +---+---+   +
|               |           |                               |         T |
+---+---+---+---+---+---+---+---+---+---+---+---+---+---+---+---+---+---+
