#####################################
#O    #       #             #       #
##### ### ### ######### ### # # #####
#   #   # # #       #   #   # # #   #
# ##### # # ####### # ##### # # # # #
#     #   #         # #   # # #   # #
# ### ##### ######### # # ### ##### #
# #       #   #     #   #     #     #
# # ######### # ### # ######### ### #
# #       #   # #   #   #     #   # #
# ####### # ### # ##### # ### ### ###
#   #     # #   # #     # #     #   #
# ### ### # ### ### ####### ### ### #
# #   #   #   #   # #     #   #   # #
# # # ####### # # # ### # ### ##### #
# # # #   #   # #   #   #   # #     #
### ### # # ### ##### ##### # # ### #
#   #   #   # # #     #   #   # #   #
# # # ####### # # ##### ##### # #####
# # # #       # #     #       #     #
# # # ### # ### # ### # ########### #
# # #   # #     # #   #     #     # #
# ##### # ######### ####### # ### # #
#     # # #         #       #   # # #
# ### # # ##### ######### ##### # # #
# #   # #     # #       #       # # #
### # # ##### # # ##### ####### ### #
#   # #   #   # #   # #   #     #   #
# ### ### ### # ### # ### ####### # #
# #     #   #     # #   #       # # #
# ######### ##### # ### ####### # # #
# #         #     # #   #       # # #
# # ############### # ### ####### # #
# # #     #         # #   #       # #
# # ### # ### ####### # ##### ##### #
#       #     #               #    T#
#####################################
