#####################################
#O  #   #   #   #     #   #   #     #
### # # # # # # ##### # # # # # ### #
# # # #   #   #   #   # #   #   #   #
# # # ### ####### # ### ######### ###
#   #   # #     #   #   #       #   #
# ### # ### ### ##### ####### # ### #
# #   #     # #       #     # # #   #
# # ######### ########### # # ### # #
# # #                 #   #   #   # #
# # ##### # ######### # ##### # ### #
# #   #   # #       #   #     # #   #
# ### # ##### ##### # ######### # ###
# # # #       #     # #     #   # # #
# # # # ####### ##### # ### # ### # #
# #   #   #   # #   # #   # #   # # #
# # ####### # # # # # ### # # # # # #
# #         # # # # #   # # # # #   #
# ########### # # ##### # # ### ### #
#   # #     #   #       # #   # #   #
### # # ### # ######### # ### # ### #
# # # #   #   #   #   # # # # #   # #
# # # ### ##### # # # ### # # # # # #
#   # #   # #   #   #     # # # # # #
# ### # ### # ############# # ### ###
# #   #     #           #   #   #   #
# # # ##### ########### # # ### ### #
# # # #     #           # #   # #   #
# # # # ##### # ######### ##### # ###
# # #   #   # # #   #   # #     #   #
# # ####### # ### # # # # # ####### #
# #     #   #     #   # #   #       #
# ##### # ############# # ### ##### #
#   #     #   #         #     #     #
### ####### # # ############### #####
#           #   #                  T#
#####################################
