#######################################
#O#               #   #           #   #
# ########### ### # # # ######### # ###
#     #     # #     #   #     # # #   #
##### # ### # ############# # # # # # #
# #   # #   # #     #       # # # # # #
# # ### ### # # ### # ####### # # ### #
#   #     # # # # # #     #   # #   # #
# ####### # # # # # ##### # ### ### # #
# #     # #   #   #     # #       # # #
# ### # # ####### ##### # ####### # # #
#   # #   #       #   # # #   #   #   #
### # ### # ######### # # # # ####### #
# # #   # #       #   # #   # #     # #
# # # # # ####### # # # ### # # # ### #
# # # # # #     #   # #   # #   # #   #
# # # # # # ### ##### ### ### ### # ###
#   # # # #   #     #   #   #   #   # #
# ### # ##### ##### # ##### ### ##### #
#   # #       # #   # #     # # #     #
### # ######### # ### # ##### # # # # #
# # # #   #     # #   #     #   # # # #
# # # # # ##### # # ####### # ##### # #
#   #   #     # #   #   # # #   #   # #
# ########### # ##### # # # ### # #####
# #             #     # # #   # #     #
# ############# # ##### # ### # ##### #
#     #     # #   #     #   # # #   # #
##### # ### # # ####### ### # # # # # #
#   # # #   #   #     #     # # # # # #
# ### # # ### ### ### ### ### # # # # #
#   #   # #   #   # # #   #   # # # # #
### ##### ##### ### # ##### ### # # # #
#       #       #   #       # #   # # #
# ##### ######### ########### ##### # #
# #   # #   #   #   #             #   #
# # # ### # # # # # # ##### ######### #
#   #     #   #   #       #          T#
#######################################
