+---+---+---+---+---+---+---+---+---+---+---+---+---+---+---+---+---+---+---+
| O |               |           |               |                           |
+   +   +---+---+   +---+   +   +   +   +---+   +   +---+---+---+   +---+   +
|   |   |       |       |   |   |   |       |   |           |   |   |       |
+   +   +   +   +---+   +   +---+   +---+   +   +---+---+   +   +   +   +---+
|       |   |   |   |   |               |   |       |       |   |   |       |
+---+---+   +   +   +   +---+---+   +---+   +---+   +   +---+   +   +---+---+
|           |   |   |           |   |       |   |   |           |           |
+   +---+---+   +   +---+---+   +---+   +---+   +   +---+---+---+---+---+   +
|           |   |           |       |   |       |   |                   |   |
+   +---+   +   +   +---+---+---+   +   +   +   +   +   +---+---+---+   +   +
|       |   |       |               |   |   |   |       |   |       |   |   |
+---+---+   +---+---+   +---+---+---+   +   +---+---+---+   +   +   +   +   +
|           |       |   |               |               |       |   |   |   |
+   +---+---+   +   +   +   +---+---+---+---+   +---+   +   +---+   +   +   +
|               |       |       |               |       |       |       |   |
+   +---+---+---+---+---+---+   +   +   +---+---+---+---+---+   +---+---+   +
|           |       |           |   |       |               |   |           |
+---+---+   +   +   +   +   +---+---+---+   +   +---+---+   +   +   +---+---+
|           |   |       |   |               |   |       |   |   |           |
+   +---+---+---+---+---+   +   +   +---+   +   +---+   +   +   +---+---+   +
|   |                       |   |       |   |           |   |           |   |
+   +   +---+---+---+---+---+   +---+   +---+   +---+---+   +---+---+   +   +
|       |                           |           |                   |   |   |
+---+---+   +---+---+---+---+   +---+---+---+---+   +---+---+---+   +   +   +
|           |               |   |                   |               |       |
+---+---+---+   +---+---+   +---+   +---+---+   +---+---+---+   +---+---+   +
|               |       |           |       |   |           |           |   |
+   +---+---+---+   +   +---+---+---+---+   +   +   +---+   +---+---+---+   +
|           |       |       |               |   |   |   |                   |
+   +---+   +---+---+---+   +   +   +---+   +   +   +   +---+---+---+---+---+
|       |       |       |       |       |   |   |   |           |       |   |
+   +---+---+   +   +   +---+   +---+   +---+   +   +   +---+   +   +   +   +
|   |       |   |   |       |       |           |       |   |   |   |       |
+---+   +   +   +   +---+   +---+---+---+---+---+---+---+   +   +   +---+---+
|       |       |   |   |   |                       |       |   |           |
+   +---+---+---+   +   +   +   +---+---+---+   +---+   +   +   +---+---+   +
|                       |                   |           |                 T |
+---+---+---+---+---+---+---+---+---+---+---+---+---+---+---+---+---+---+---+
