#######################################
#O#       #     #       #             #
# # ##### ### # # # ### # ####### ### #
# # #   #   # # # #   # #     # # #   #
# # # # ### # ### ### # ##### # # # ###
#   # # # # #       # #   #   # # #   #
##### # # # ##### ### ### # ### # #####
#     # # #     # #   # # #     #     #
# ##### # ##### ### ### # ########### #
#     # #     #   # #   # #         # #
# ### # # ####### # # # # # ####### # #
#   # #   #       # # # #   # #   # # #
##### ##### ####### # ####### # # # # #
#     #   # #       #       #   # # # #
# ##### # # # ######### ### # ### # # #
#       #   #   #       #   #   #   # #
# ############# # # ########### ##### #
#     #   #     # #   #       # #     #
##### # # # # ####### # ##### # # #####
#     # #   # #       # #   # # #     #
# ########### # # ### # ### # # ##### #
# #           # #   # #     # #     # #
# # ########### ### ### ##### ##### # #
#   #             #     #         # # #
##### ######### ######### ####### # # #
#     #       # #         #       #   #
####### ##### ### ##### ####### ##### #
#       #   #     #   # #     #     # #
# ####### # ######### # # ### ####### #
#     #   #   #       # # # #         #
# ### ####### # # ### # # # ###########
#   #   #   #   #   # # # #     #   # #
# ##### # # ### ### ### # # ### # # # #
# #   # # #   #   #     #   # # # #   #
### # # # ### ############### # # #####
#   #   # # # #           #   # #     #
# ####### # # # ####### ### # # ##### #
#           #         #     #        T#
#######################################
