+---+---+---+---+---+---+---+---+---+---+---+---+---+---+---+---+---+---+---+
| O |   |                   |                       |                       |
+   +   +   +---+---+---+   +   +   +---+   +---+---+   +   +---+---+---+   +
|   |       |           |   |   |       |   |           |       |   |       |
+   +   +---+---+   +   +   +   +---+   +   +   +---+---+---+   +   +   +---+
|   |               |   |       |       |   |           |   |   |           |
+   +---+---+---+---+   +---+---+   +---+   +---+---+   +   +   +---+---+   +
|   |       |           |       |       |   |           |   |       |       |
+   +---+   +   +---+---+   +---+---+   +---+   +---+---+   +---+   +   +---+
|   |       |   |   |           |       |       |               |   |       |
+   +   +---+   +   +   +---+   +   +---+   +---+---+   +---+   +   +---+---+
|   |   |       |       |       |           |       |       |   |           |
+   +   +   +---+   +---+   +   +---+---+---+   +   +---+   +   +---+---+   +
|   |       |           |   |       |           |       |   |       |       |
+   +   +---+---+---+   +   +---+   +   +---+---+---+   +   +---+   +   +---+
|   |               |   |       |   |       |   |       |       |   |       |
+   +---+---+---+   +---+---+   +   +---+   +   +   +---+---+   +---+---+   +
|   |           |   |           |       |   |       |           |           |
+   +   +---+   +   +   +---+---+---+   +   +   +---+   +   +---+   +---+   +
|       |       |   |   |                   |           |   |       |   |   |
+---+---+   +---+   +   +---+---+---+---+---+---+---+---+   +   +---+   +   +
|       |   |           |                   |   |       |   |   |           |
+   +---+   +   +---+---+   +---+---+---+   +   +   +   +   +   +---+---+   +
|   |       |   |           |           |   |       |   |   |           |   |
+   +   +---+---+   +---+---+   +---+---+   +---+   +   +   +---+---+   +   +
|   |               |   |               |       |   |       |       |   |   |
+   +---+---+---+---+   +   +---+---+   +---+   +---+---+---+   +   +   +   +
|       |       |       |       |       |       |               |       |   |
+   +   +---+   +   +   +   +---+   +   +   +---+   +---+---+---+---+---+   +
|   |   |       |   |       |       |   |   |       |               |       |
+   +   +   +   +   +---+---+   +   +---+   +   +   +---+   +---+   +   +---+
|   |       |   |   |           |   |       |   |       |       |       |   |
+   +---+---+   +   +   +---+   +---+   +---+---+---+   +---+---+   +---+   +
|       |       |   |   |       |       |           |   |       |   |       |
+---+   +   +---+   +   +   +---+   +---+   +---+   +   +   +   +   +   +---+
|       |       |   |   |   |       |       |   |   |       |   |   |       |
+   +---+---+---+   +   +---+   +---+---+   +   +   +---+---+   +   +---+   +
|                   |                       |                   |         T |
+---+---+---+---+---+---+---+---+---+---+---+---+---+---+---+---+---+---+---+
