+---+---+---+---+---+---+---+---+---+---+---+---+---+---+---+---+---+---+---+
| O |                               |       |                       |       |
+   +---+---+---+---+---+   +---+   +   +   +   +---+---+---+---+   +   +---+
|           |           |   |           |       |           |   |   |       |
+---+---+   +   +---+   +   +---+---+---+---+---+---+   +   +   +   +   +   +
|   |       |   |       |   |           |               |   |   |   |   |   |
+   +   +---+   +---+   +   +   +---+   +   +---+---+---+   +   +   +---+   +
|       |           |   |   |   |   |   |           |       |   |       |   |
+   +---+---+---+   +   +   +   +   +   +---+---+   +   +---+   +---+   +   +
|   |           |   |       |       |           |   |               |   |   |
+   +---+   +   +   +---+---+---+   +---+---+   +   +---+---+---+   +   +   +
|       |   |       |               |       |   |   |       |       |       |
+---+   +   +---+   +   +---+---+---+---+   +   +   +   +   +---+---+---+   +
|   |   |       |   |               |       |   |       |   |           |   |
+   +   +   +   +   +---+---+---+   +   +   +   +---+   +   +   +   +---+   +
|   |   |   |   |   |           |       |   |       |   |       |   |       |
+   +   +   +   +   +   +---+   +---+---+   +---+   +---+   +---+   +   +---+
|       |   |   |   |       |           |       |       |       |       |   |
+   +---+   +   +---+---+   +---+---+   +   +---+---+   +---+   +---+---+   +
|       |   |               |   |       |   |           |   |   |           |
+---+   +   +---+---+---+---+   +   +---+   +   +---+---+   +   +   +   +   +
|   |   |   |       |           |   |       |           |       |   |   |   |
+   +   +   +   +   +---+---+   +   +   +---+---+---+   +   +---+---+   +   +
|       |       |           |   |       |       |   |   |       |       |   |
+   +---+---+---+---+---+   +   +---+---+   +   +   +   +---+   +   +---+---+
|   |                           |           |   |   |       |   |           |
+   +---+---+---+---+---+---+   +   +---+---+   +   +---+   +   +---+---+   +
|           |           |   |       |           |       |   |   |       |   |
+---+---+   +   +---+   +   +   +---+---+---+   +---+   +   +   +   +   +   +
|       |   |   |       |       |           |           |   |   |   |   |   |
+   +---+   +   +   +---+   +---+   +---+   +---+   +---+   +   +   +   +   +
|       |       |   |       |       |   |   |       |       |   |   |   |   |
+---+   +---+---+   +---+---+   +---+   +   +---+---+   +---+   +   +   +   +
|               |               |       |               |   |       |   |   |
+   +---+---+   +---+---+---+---+   +---+---+---+---+---+   +---+---+   +   +
|   |       |   |       |       |       |                           |       |
+   +   +   +---+   +   +   +   +   +   +   +---+---+   +---+---+---+---+   +
|       |           |       |       |               |                     T |
+---+---+---+---+---+---+---+---+---+---+---+---+---+---+---+---+---+---+---+
