#######################################
#O# #         #           #           #
# # # ####### # # ### ##### # ####### #
# #   #     # # #   # #     #   # #   #
# # ##### # # # ### # # ####### # # ###
# #       # #   #   # #     # # #     #
# ######### ##### ### ##### # # ##### #
# #   #     #   #   # #     # #   #   #
# ### # ##### ##### ### ##### ### # ###
# #   # # #     #   #   #       # #   #
# # ### # # ### # ### ##### ### # #####
# # #   #   #   #     #   #   # #     #
# # # ### ### # ####### # ### # ##### #
# #   #     # #   #     #   # #   #   #
# # ####### # ### # ####### # ### # ###
# #       # #   # #   # #   #   # #   #
# ####### ##### # ### # # ##### ##### #
# #     # #     #   # #   #     #     #
# # ### # # ####### # # ### # ### ### #
#   #   # # #         #     # #   # # #
##### ### # ################# # ### # #
#   # #     #         # #   # # #     #
# ### # ##### ####### # # # # # ##### #
# #   # #     #     # #   # # #     # #
# # ##### ##### ##### ### # # ##### # #
# #       # #       #   # #   #   # # #
# ######### # ##### ### ####### # # # #
#   #   #   #   #   #   #       #   # #
# # ### # # # ### # # ### ########### #
# # #   # #   #   # # #   #       #   #
# # # # # ##### # ### # # ### ### # ###
# #   # # #     # #   # #   #   #   # #
# ##### # # ### ### ####### ##### ### #
#   #   # # #   #   #     # #   # #   #
### # ### # # ### ### ### # # # # # ###
#   #   # # # #   #   # # #   # # #   #
# ####### # ### ##### # # ##### # ### #
#         #           #         #    T#
#######################################
