+---+---+---+---+---+
| O     |           |
+---+   +   +---+   +
|   |   |       |   |
+   +   +   +   +---+
|       |   |       |
+   +---+   +---+   +
|   |           |   |
+   +---+---+---+   +
|                 T |
+---+---+---+---+---+
