+---+---+---+---+---+---+---+---+---+---+---+---+---+---+---+---+---+---+---+---+---+---+---+---+
| O     |               |       |                   |   |           |       |           |       |
+---+   +---+---+---+   +   +   +   +---+---+   +   +   +   +   +   +---+   +   +   +   +   +   +
|   |           |       |   |       |   |       |       |   |   |       |       |   |   |   |   |
+   +---+---+   +   +---+   +---+---+   +   +---+---+---+   +   +---+   +---+---+   +---+   +   +
|   |           |                       |   |       |       |   |   |           |       |   |   |
+   +   +---+---+   +---+---+---+---+   +   +   +   +   +---+   +   +---+---+   +   +   +   +   +
|       |       |   |           |       |   |   |       |   |   |           |   |   |       |   |
+   +---+   +   +   +   +---+   +---+---+   +   +---+---+   +   +---+   +---+   +   +---+---+   +
|           |   |   |   |                   |   |           |   |       |       |       |       |
+---+---+---+   +---+   +---+---+---+---+---+   +   +   +---+   +   +---+   +---+   +---+   +   +
|   |           |       |           |           |   |       |   |           |       |       |   |
+   +   +---+---+   +   +   +---+   +   +---+---+   +---+   +   +---+   +---+---+---+   +---+   +
|   |       |       |   |   |   |   |       |       |       |       |   |               |       |
+   +---+   +   +   +---+   +   +   +---+   +---+---+   +   +---+   +   +   +---+---+---+---+---+
|           |   |   |       |   |       |               |       |   |       |                   |
+   +---+---+   +---+   +---+   +---+   +---+---+---+   +---+---+   +---+   +   +---+---+---+   +
|       |           |   |           |               |   |           |       |       |       |   |
+---+   +   +---+   +   +---+   +   +---+   +   +---+   +   +---+---+   +---+---+   +   +   +   +
|       |   |       |       |   |       |   |   |       |   |       |       |       |   |   |   |
+   +---+   +   +---+---+   +   +---+   +   +   +   +---+   +---+   +   +---+   +---+   +   +   +
|   |   |   |               |       |   |   |   |   |   |       |       |       |       |       |
+   +   +   +---+---+---+---+   +   +   +   +---+   +   +---+   +---+---+   +---+   +---+---+   +
|   |       |           |       |   |   |           |       |       |           |       |   |   |
+   +---+   +   +---+   +---+---+   +   +---+---+---+   +   +---+   +   +---+---+---+   +   +   +
|       |       |                   |       |           |       |       |               |       |
+---+   +---+---+   +---+---+---+---+---+   +   +---+---+---+   +---+---+   +---+---+---+   +---+
|       |               |           |   |       |           |       |   |           |       |   |
+   +---+---+---+---+   +   +---+   +   +---+---+   +---+   +---+   +   +---+---+   +   +---+   +
|               |       |       |   |               |           |       |           |           |
+---+---+---+   +   +---+---+   +   +---+   +---+   +---+---+---+---+   +   +---+---+---+---+---+
|               |   |           |       |   |   |           |       |   |                       |
+   +---+---+---+---+   +---+---+---+   +   +   +---+---+   +   +   +   +---+---+---+---+---+   +
|   |   |               |           |   |   |           |       |           |                   |
+   +   +   +   +---+---+   +---+   +   +   +   +---+   +---+---+---+---+---+   +---+---+---+   +
|   |       |   |   |       |       |   |       |       |           |           |       |       |
+   +   +---+   +   +   +   +---+---+   +---+---+   +---+---+   +---+   +---+---+   +   +   +---+
|   |       |   |   |   |   |           |       |           |       |   |           |   |       |
+   +---+---+   +   +   +   +   +---+---+   +---+---+---+   +---+   +   +   +---+---+---+---+   +
|               |       |   |   |               |                   |   |                       |
+---+---+---+---+---+---+   +   +---+---+   +   +   +---+---+---+   +   +---+---+---+---+---+---+
|               |           |   |       |   |       |       |   |   |   |                       |
+---+   +---+   +   +---+   +   +   +   +   +---+---+   +   +   +   +   +   +---+---+   +---+   +
|       |           |       |       |   |       |       |   |       |       |       |       |   |
+   +---+---+   +---+---+---+---+---+   +---+---+   +---+   +---+---+   +---+   +   +---+---+   +
|   |       |   |                       |           |   |   |       |   |       |           |   |
+   +   +   +---+   +---+---+---+---+---+   +---+---+   +   +   +   +---+   +---+---+---+   +   +
|       |                                   |                   |           |                 T |
+---+---+---+---+---+---+---+---+---+---+---+---+---+---+---+---+---+---+---+---+---+---+---+---+
