+---+---+---+---+---+---+---+---+---+---+---+---+---+---+---+---+---+---+---+---+---+---+---+---+
| O |       |           |   |                                   |                               |
+   +   +   +---+   +   +   +   +---+---+---+---+---+---+   +---+   +---+---+---+   +---+   +   +
|       |   |       |   |   |   |           |           |           |   |       |   |       |   |
+---+---+   +   +---+   +   +   +   +   +   +---+   +---+---+---+---+   +   +   +   +   +---+   +
|       |       |   |   |       |   |   |       |   |                   |   |   |   |       |   |
+   +---+---+---+   +   +---+   +---+   +---+   +   +   +---+   +---+---+   +   +---+---+   +   +
|                   |       |           |   |   |           |       |       |               |   |
+   +   +---+---+---+---+   +---+---+---+   +   +---+---+---+---+   +   +---+---+---+---+---+---+
|   |           |       |               |       |                   |   |           |           |
+   +---+---+   +   +   +---+---+---+   +   +---+   +---+---+---+   +   +   +---+   +   +---+   +
|       |       |   |           |   |   |       |       |       |   |   |       |       |   |   |
+---+   +   +   +   +---+   +   +   +   +---+   +   +   +---+   +   +   +---+   +---+---+   +   +
|   |   |   |   |   |       |       |   |   |   |   |       |       |           |           |   |
+   +   +   +---+   +   +---+---+---+   +   +   +   +---+   +   +---+---+---+---+---+   +   +   +
|   |   |   |       |   |               |       |       |   |               |           |   |   |
+   +   +   +   +---+   +   +---+---+---+---+   +---+   +   +---+---+---+   +   +   +---+---+   +
|       |       |   |       |               |   |       |       |       |       |   |           |
+   +---+---+---+   +---+---+---+   +---+   +   +---+---+---+   +   +---+---+---+   +   +---+   +
|   |       |                       |   |   |                   |       |           |       |   |
+   +   +   +   +---+---+   +---+---+   +   +---+---+   +---+---+   +   +   +---+---+---+   +   +
|       |   |   |           |           |       |       |       |   |           |           |   |
+---+---+   +---+   +---+---+   +---+   +---+   +---+---+   +   +---+   +---+---+   +---+---+   +
|   |       |       |       |       |       |               |       |   |   |       |       |   |
+   +   +---+   +---+---+   +---+   +---+   +---+---+---+---+---+   +   +   +   +---+   +   +   +
|       |   |           |           |   |           |       |       |   |   |   |       |   |   |
+   +---+   +   +---+   +---+---+   +   +   +---+---+   +   +   +---+   +   +   +   +---+---+   +
|   |               |           |   |   |               |       |           |   |           |   |
+   +---+---+---+---+---+   +   +   +   +---+---+---+---+---+---+---+---+---+   +   +---+   +   +
|                       |   |   |   |           |       |       |           |   |   |   |       |
+---+---+---+---+---+   +---+   +   +---+   +   +   +   +   +   +   +---+   +   +   +   +---+---+
|           |           |       |   |       |   |   |       |       |   |       |       |       |
+   +   +   +   +---+---+   +---+   +   +---+   +   +---+---+---+---+   +---+---+---+   +---+   +
|   |   |   |               |   |   |   |       |               |       |           |           |
+---+   +   +---+---+---+---+   +   +   +   +---+---+---+---+   +---+   +   +---+   +---+---+   +
|       |   |               |   |       |                   |       |           |           |   |
+   +---+   +   +---+---+   +   +---+---+---+---+---+---+   +   +   +---+---+   +---+---+   +   +
|   |   |   |           |   |                   |   |       |   |           |           |       |
+   +   +   +   +---+   +   +   +---+---+---+   +   +   +---+   +---+---+   +---+---+---+---+   +
|   |       |   |       |   |   |       |       |   |       |           |                   |   |
+   +---+   +---+   +---+   +   +   +   +---+   +   +---+   +---+---+---+   +---+---+   +   +   +
|       |   |       |           |   |       |   |       |   |           |   |       |   |   |   |
+   +   +   +   +---+---+---+---+   +---+   +   +   +---+   +   +---+   +---+   +   +   +   +   +
|   |   |       |                   |   |   |       |       |   |   |           |   |   |   |   |
+   +   +---+   +   +---+---+---+---+   +   +---+---+   +---+   +   +---+---+---+   +---+   +   +
|   |   |       |       |       |       |   |       |       |   |           |       |       |   |
+   +   +---+---+---+   +   +   +---+   +   +   +   +---+   +   +   +---+---+   +---+   +---+   +
|   |                       |           |       |               |                       |     T |
+---+---+---+---+---+---+---+---+---+---+---+---+---+---+---+---+---+---+---+---+---+---+---+---+
