#################################################
#O  #       #   #         # #     #   #     #   #
### ####### # # # ##### # # # # # ### # # # # # #
# #     #   # #   # #   #   # # #   #   # # # # #
# ##### # ### ##### # ####### # ### ##### ### # #
# #     #           # #   #   # # #     #   # # #
# # ##### ######### # # # # ### # ##### # # # # #
#   #   # #     #   # # #   # # #     # # #   # #
# ### # # # ### ##### # ##### # ### ### # ##### #
#     # # # #         # #     # #   #   #   #   #
####### ### ########### # # ### # ### ### ### # #
# #     #   #     #     # #   # #     #   #   # #
# # ##### # # ### # ##### ### # ### ####### ### #
# #   #   # # # # #   #   #   #   # #       #   #
# ### # # ### # # ### ##### # ### # # ###########
#     # # #   # #   #       #   # #   #         #
# ##### ### ### ### ####### ##### ### # ####### #
#   #     # #     #       # #     #   #   #   # #
### # ### # ### # ### # ### # ##### ##### # # # #
#   # #   #   # #   # # #   # #   #   #   # # # #
# ### # ##### # ### # # # ### ### # ### ### # # #
# # # #       #   # # # # # #   #   #   #   #   #
# # # ######### # # # ### # ### ##### ### ##### #
# #   #     #   # # #     #   #   #     #   # # #
# ### # ### ##### # ####### # ### # ####### # # #
#   #   #         #   #     #   #   #       #   #
### ##### ########### # ####### ##### ####### ###
#   #       #     # #   #     #   # #     #   # #
# ######### # ### # ##### ### ### # ##### # ### #
#       #   #   # #       #     #   #     #     #
####### # ##### # ### ### ######### # ###########
#       # #     #   # # #     #   # #           #
# ######### ####### # # ##### # # # ########### #
# # #       #     # # #     #   #     #         #
# # # # ##### ### # # # ### ########### ####### #
# #   # # #   #   # #   #   #     #     #   #   #
# # ### # # # ##### ##### ##### ### ##### # # ###
# #   # # # # #     #   #     #   # #     # #   #
# ##### # # # # ##### ####### ### # # ######### #
#       #   # # #       #         # #           #
############# # ##### # # ####### # #############
#       #     # #   # #   #   # # # #           #
### ### # ### # # # # ##### # # # # # ##### ### #
#   #     #   #   # #   #   # #   #   #   #   # #
# ##### ########### ##### ### ##### ### # ##### #
# #   # #           #     # # #   # #   #     # #
# # # ### ########### ##### # # # ### ####### # #
#   #                 #         #     #        T#
#################################################
