#################################################
#O  #         #         #           # #         #
### # ####### ### ### # ##### # ### # # ####### #
# # # #         # #   #     # #   # #   #       #
# # # ######### # # ####### ##### # # ### ##### #
#   #       #   # # #             # #   #   # # #
# ### ##### # ##### ############### ####### # # #
#   #   #   # #     #     #       #         # # #
### ### # ### # # ### ### # ##### ########### # #
# #   # #   # # #       #       # #             #
# ### # ### # ######### ####### # # ####### #####
#   # # #   # #       #   #   # # #   #   #     #
# # # # # ### # ##### ##### # ### ### # # ##### #
# # # # # #   # #   #   #   #     # # # #   #   #
# # # ### # ### # # ### # ######### # # ### # ###
# # # #   # #   # # #   #     #   #   #   # #   #
### # # ### # # # # # ### ### # ### ##### # #####
#   #   # # # # # # #   #   # # #   #     #     #
# ####### # # # ### ### ### # # # ### ######### #
#         # # # #     #   # # #     #     #   # #
# ####### # # # # ####### # # ##### ##### ### # #
#     # #   # # #   #     # #     # #   #     # #
##### # ##### # ### # ##### ##### # # # # ##### #
#     #     # #   #       #     # #   # # #   # #
# ##### # # ##### ####### ##### # ##### # # # # #
# #   # # #     #   #       #   #   #   # # # # #
# # # ### ##### # # ####### ####### # ### # # # #
#   #   # #     # # #     #     #   #   # # #   #
####### # # ##### # # ### ##### # ### ### # ### #
#   #   # #   #   #     # #   # #   # #   #   # #
# ### ### ### ######### # ### # ### ### ##### ###
#     #     #       #   # #   #   #         #   #
# ##### ### ####### # ### # ##### ######### ### #
# #   # #   #     # # #   # #   #   #     # #   #
# # # ### ### ##### ### ### # # ### # ### # # ###
#   #     #   #   # #   #   # #   #   # # # #   #
############# # # # # ##### # ### ##### # ##### #
#             # #   #     #   # # #           # #
# # # ######### ######### # ### # # ######### # #
# # # #   #   # #       # #     #   #   #   # # #
### # # # # # # # ##### # ##### ##### # # # # # #
#   # # #   # #   # #   #     # #   # # # # # # #
# ##### ##### ##### # ####### ### # # # # # # # #
#     # #   #       #       #     #   # # # #   #
# ### # ### ####### ####### ######### # # # ### #
# # # #     #     #     #   #   #   # # # #   # #
# # # ##### # ### ##### # ### # # # ### # ##### #
#   #         #       #       #   #     #      T#
#################################################
