#############
#S  # #     #
### # # # # #
#   #   # # #
# ####### # #
#         # #
########### #
#     #     #
# # # # #####
# # # #   # #
# # ##### # #
# #        E#
#############
