#############
#S#         #
# ##### # ###
# #   # #   #
# # # # ### #
#   # # # # #
##### # # # #
#   # #   # #
# # # ### # #
# #   #   # #
# ######### #
#          E#
#############
