+---+---+---+---+---+
| O |           |   |
+   +   +---+   +   +
|   |   |       |   |
+   +   +   +---+   +
|       |   |       |
+---+---+   +   +---+
|           |       |
+   +---+---+---+   +
|                 T |
+---+---+---+---+---+
