+-+-+-+-+-+-+
|S  |       |
+-+ +-+ +-+ +
| |     | | |
+ +-+-+-+ + +
|         | |
+ +-+-+-+ + +
|   |   | | |
+-+ + +-+ + +
|   | |   | |
+ +-+ + +-+ +
|     |    E|
+-+-+-+-+-+-+
