#############
#S  #       #
### ### ### #
# #     # # #
# ####### # #
#         # #
# ####### # #
#   #   # # #
### # ### # #
#   # #   # #
# ### # ### #
#     #    E#
#############
