###############################
#S#         #   #     #       #
# ### ##### # # ### # ####### #
#     # #   # #     #     #   #
####### # ### ########### # # #
# #     # #   #   #       # # #
# # # ### # ### ### ####### ###
#   #   #   #   #   #         #
# ##### ##### # # ########### #
# #   #     # #   #         # #
# ### ##### # ##### ####### # #
#   # #     #   #   #     # # #
### # # ####### # ### # ### # #
#   # #         # #   #   # # #
# ### ########### # ##### # # #
# #     #     #   # #   # # # #
# # # # ### # # # ### # # # # #
# # # #   # #   #     # #     #
# # # ### ############# ##### #
# # # # #             #     # #
# ### # ############# # ### ###
#   # # #         #   #   #   #
### # # # ####### # ##### ### #
# #   # #   #     #     #   # #
# ##### # ### ### ##### ### # #
#         #   #   #   # #   # #
# ######### ### ##### # ##### #
# #   #     #         #   #   #
# ### # ################# # # #
#     #                     #E#
###############################
