###############################
#S#             #       #     #
# # ########### ### ### ##### #
# #   #       # #   # # #   # #
# # # ##### ### # ### # # # # #
# # #     #   # #   # #   #   #
# ####### # # # ### # ####### #
#     #   # # #     # #       #
##### # ##### ####### # #######
#   #   #         #   # #     #
# # ##### ####### # # # ##### #
# #       #       # # # #   # #
# ##### ####### ### # # # # # #
#     #       # # # #   # # # #
##### ####### # # # ##### # # #
#   #       # #   #       # # #
# ##### ##### ### ######### # #
#       #     #           #   #
# ####### ########### ####### #
# #   #   #       #   #     # #
# # # # ### ##### ### # # ### #
# # # #     #   #   # # #     #
# # # ####### ##### ### #######
#   # #   #   #     #   #     #
##### # # # # # ### # ### ### #
#   #   #   # #   # #   #   # #
# # ####### ##### # ### ##### #
# #   #   # #     #   # #     #
# ##### # # # ######### # ### #
#       #   #             #  E#
###############################
