#############
#S#   #     #
# # # # # ###
# # #   #   #
# ##### ### #
#     #   # #
##### ### # #
#   # #   # #
# ### # ### #
#     #   # #
# ######### #
#          E#
#############
