+---+---+---+---+---+
| O     |           |
+---+   +---+---+   +
|       |       |   |
+   +---+   +   +   +
|       |   |       |
+---+   +   +---+   +
|       |       |   |
+   +---+---+   +   +
|               | T |
+---+---+---+---+---+
