#############
#S#         #
# # #########
# #   #     #
# # # # ### #
# # #   #   #
# ### ### # #
#   #   # # #
### # ### # #
# # # #   # #
# # ### ### #
#       #  E#
#############
