###############################
#S#   #       #       #       #
# # ### # ### ##### # # ##### #
# #     #   #   #   # # #   # #
# # ####### ### # ### # # # # #
# #       # # #   # # # # # # #
# ######### # ##### # # ### # #
#         # #     #   #   #   #
######### # ##### # ##### # ###
#   #   #   #     # #     # # #
# # # # ##### ##### ### ### # #
# # # #       #   #   # # #   #
# # # ##### # # # ### # # ### #
# # #   #   # # #     # #     #
### ### # ##### ####### # #####
#     # #       #       #   # #
# ##### ########### ####### # #
# #   # #       #   #   #   # #
# # # # ##### # # ### # # ### #
# # # # #   # #   #   # #     #
# # # # # # # ##### ### ##### #
#   #   # # #   #   #       # #
# ####### # # # ### ######### #
#         # # #   #           #
########### # ### ### #########
#     #   # #   #   #   #   # #
### # # ### ####### ### # # # #
#   #   #   #     # # # # # # #
# ####### ### ### # # # # # # #
#             #     #     #  E#
###############################
