###############################
#S    #           #           #
##### # ### ####### # #########
#   # #   #   #   # # #       #
# # # ####### # # # # # ##### #
# # #   #   #   # # #   # #   #
# # ### # # ##### # ##### # ###
# #   # # # #   # # #     #   #
# ### # # # # # # # # # ##### #
# # #   # #   #   # # # #     #
# # ##### ######### # # # #####
# #   #     #         # # #   #
# # # ##### # ####### ### # # #
# # # #   #     #   # #   # # #
# # # # # ##### # # ### ### # #
# # #   #     # # #   #     # #
# # ######### ### ### ##### # #
#   #       #   #   #     # # #
##### # ### ### ### ##### ### #
# #   # #     #     #   #   # #
# # ### ############### ### # #
# #   # #     #           #   #
# # ### # ### # # ### ####### #
# # #   #   #   #   # #       #
# # # ##### ####### ### #######
#   #     #   #   #   #   #   #
# ####### ### # ##### ### # # #
# #   # #     #     # #   # # #
# # # # ######### # # # ##### #
#   #             # #        E#
###############################
