+---+---+---+---+---+
| O |           |   |
+   +---+   +   +   +
|       |   |   |   |
+---+   +   +   +   +
|   |       |   |   |
+   +---+---+   +   +
|       |       |   |
+   +   +   +---+   +
|   |             T |
+---+---+---+---+---+
