#######
#S    #
##### #
#   # #
# ### #
#    E#
#######
