#######
#S  # #
### # #
# #   #
# ### #
#    E#
#######
