#############
#S    #     #
##### # ### #
# #   #   # #
# # ####### #
# # #     # #
# # # ### # #
#   # # #   #
# ### # ### #
#   # #   # #
### # # # # #
#     # #  E#
#############
