+-+-+-+-+-+-+
|S    |     |
+-+-+ + +-+ +
| |   |   | |
+ + +-+-+-+ +
| | |     | |
+ + + +-+ + +
|   | | |   |
+ +-+ + +-+ +
|   | |   | |
+-+ + + + + +
|     | |  E|
+-+-+-+-+-+-+
