###############################
#S#       #       #   #       #
# ### ##### # ### # # ####### #
# #   #     #   #   #     #   #
# # ### ####### ######### # ###
# # #   # #   # #       # #   #
# # # ### # # # # ### ### ### #
# #     #   # # #   #         #
# ##### ##### # ############# #
# #   #     # #       #   #   #
# # # ##### # ####### # # ### #
#   # #   # #   #   # # #   # #
##### # # # # # # # # # ### # #
#   #   # #   #   # #     # # #
# # ##### ################# # #
# #     #   #         #     # #
# ### # ### # ####### # ##### #
# # # # #   #       #   # #   #
# # # ### ######### ##### # ###
#   #   #       #   #         #
### ### ####### # #############
# #   #     #   #     #       #
# ### ##### # ### ### # ##### #
#   #   # #   #     #       # #
# # ### # ########### ####### #
# #   # #           # #       #
# ##### # # ####### ### ##### #
# #   # # #   #   #     # #   #
# # # # ##### # # ####### # ###
#   #         # #            E#
###############################
