#############
#S  #       #
### ### ### #
# #     #   #
# ####### ###
#       # # #
### ##### # #
#   #     # #
# ### ##### #
#   # #     #
# # # # ### #
# #     #  E#
#############
