+-+-+-+-+-+-+-+-+-+-+-+-+-+-+-+
|S|   |                 |     |
+ + + + + +-+-+-+-+-+-+ + + +-+
|   | | |       |     | | |   |
+-+-+ +-+ +-+-+ + +-+ + + +-+ +
|   |   | |   | |   | | | |   |
+-+ +-+ + + +-+ + +-+ + +-+ + +
|   | | |   |   | |   |     | |
+ + + + +-+ + +-+ + +-+-+-+-+ +
| |   | |   |   | |     |     |
+ +-+-+ +-+-+-+ + +-+ + + +-+-+
|   |   |       | |   | | |   |
+ + + +-+ +-+-+-+ + +-+ + +-+ +
| |   |   | |     |   | | |   |
+ +-+-+ +-+ + +-+-+-+ +-+ + + +
|     | |   | |     |   |   | |
+-+-+ + + +-+ + +-+ +-+ +-+-+ +
|   |   |     |   |   |   |   |
+ +-+-+-+ +-+-+-+ +-+ +-+ + +-+
|       | |       |     |   | |
+ +-+-+ + + +-+-+-+-+-+-+-+-+ +
| |   |   | |             |   |
+ +-+ +-+-+ + +-+-+-+ + + + + +
|   |     |   |     | | |   | |
+-+ + +-+ +-+ + +-+ + + +-+-+-+
|   |   |   | | | | | |       |
+ +-+-+ +-+ +-+ + + + +-+-+-+ +
| |   |   |     |   |   |   | |
+ + + +-+ +-+-+-+ +-+-+-+ + + +
|   |     |               |  E|
+-+-+-+-+-+-+-+-+-+-+-+-+-+-+-+
