###############################
#S#   #                 #     #
# # # # # ############# # # ###
#   # # #       #     # # #   #
##### ### ##### # ### # # ### #
#   #   # #   # #   # # # #   #
### ### # # ### # ### # ### # #
#   # # #   #   # #   #     # #
# # # # ### # ### # ######### #
# #   # #   #   # #     #     #
# ##### ####### # ### # # #####
#   #   #       # #   # # #   #
# # # ### ####### # ### # ### #
# #   #   # #     #   # # #   #
# ##### ### # ####### ### # # #
#     # #   # #     #   #   # #
##### # # ### # ### ### ##### #
#   #   #     #   #   #   #   #
# ####### ####### ### ### # ###
#       # #       #     #   # #
# ##### # # ################# #
# #   #   # #             #   #
# ### ##### # ####### # # # # #
#   #     #   #     # # #   # #
### # ### ### # ### # # #######
#   #   #   # # # # # #       #
# ##### ### ### # # # ####### #
# #   #   #     #   #   #   # #
# # # ### ####### ####### # # #
#   #     #               #  E#
###############################
