###############################
#S#           #     #         #
# ### ######### # ### ### ### #
#   # #   #     #     #   # # #
### # # # # ########### ### # #
# # #   #   #         #   # # #
# # # ####### ####### # # # # #
#   #     #   #     # # # #   #
# ### ##### ##### # # ### ### #
#   # #     #     # #   #   # #
### # # ##### ##### ### ### ###
#   # # #   #   # #   #   #   #
# ### # # # # # # ### ### # # #
# #   # # #   # #     #   # # #
# # ### ##### # ##### # ##### #
# #   #     # # #   # #       #
# ### ##### # # # # # ####### #
# #   #     # #   # #       # #
# ##### ####### ### ####### # #
# #   #       #   # #   #   # #
# # # ##### # ##### # ### ### #
#   #     # #   #   #       # #
######### # ### # ### ####### #
#       # # #   #   # #   #   #
# ##### # # # ##### # # # # ###
# #     # # # #     #   # # # #
# # ### # ### # ######### # # #
# # #   #     #     #   # #   #
# # ########### ### # # ##### #
# #               #   #      E#
###############################
