###############################
#S#     #   #         #       #
# ### # # # # ### ### ##### # #
#   # # # # #   # #   #   # # #
### ### # # ### # # ### # # ###
# #   #   #     # #   # # #   #
# ### # ######### ### # # ### #
#   # #   #   #   #     #     #
# ### # ### # # ############# #
#   # # #   # #   #       #   #
### # ### ### ### # ##### # ###
#   #   #   #   #   #   # # # #
# ##### # # ### ##### # # # # #
#       # # # #       # # # # #
# ######### # ######### # # # #
# #         #         #   #   #
# # ### ####### # ########### #
# #   # #       # #           #
# # ### ##### ##### ###########
# # #   #     #     #     #   #
# ### ### # ### ##### ##### # #
#     #   # #   #           # #
####### # ### ######### ##### #
#     # # #   #       # #     #
### # # # # ##### ### ### ### #
#   # # #   #     # #     #   #
# ##### ##### # ### ####### ###
# #   #   #   #   #   #     # #
# # # ### ####### # ### ##### #
#   #             #          E#
###############################
