#############
#S#   #     #
# # # ### # #
#   # #   # #
##### # ### #
#   # # #   #
# ### # # ###
#   #   # # #
# # ##### # #
# # #     # #
# # # ##### #
# #        E#
#############
