#############
#S  #   #   #
### # # # # #
#   # #   # #
# ### ##### #
# #   #   # #
# ##### # # #
#       #   #
########### #
#         # #
# ######### #
#          E#
#############
