###############
#O    #   #   #
##### # # # # #
#   #   #   # #
# # ######### #
# #     #     #
# ####### #####
# #       #   #
# # ####### # #
#   #       # #
# ######### # #
# #   #   # # #
# # # # # ### #
#   #   #    T#
###############
