+---+---+---+---+---+---+---+
| O |               |       |
+   +   +---+---+   +---+   +
|   |   |       |       |   |
+   +   +   +   +---+   +   +
|       |   |       |   |   |
+---+---+   +---+---+   +   +
|       |       |       |   |
+   +---+   +   +   +---+   +
|           |   |   |       |
+   +---+---+   +   +---+   +
|   |       |   |           |
+   +---+   +   +---+---+   +
|           |             T |
+---+---+---+---+---+---+---+
