+---+---+---+---+---+---+---+
| O         |               |
+---+---+   +   +   +---+---+
|           |   |           |
+   +---+---+   +---+---+   +
|       |   |           |   |
+---+   +   +---+---+   +   +
|   |   |           |   |   |
+   +   +   +---+   +   +   +
|       |       |       |   |
+   +---+   +---+---+---+   +
|   |       |       |       |
+   +---+---+   +   +   +   +
|               |       | T |
+---+---+---+---+---+---+---+
