+---+---+---+---+---+---+---+
| O         |       |       |
+---+---+   +   +   +   +   +
|       |       |       |   |
+   +   +---+---+---+---+   +
|   |           |           |
+   +---+---+---+   +---+---+
|   |               |       |
+   +   +---+---+---+   +   +
|       |               |   |
+   +---+---+---+---+   +   +
|   |       |       |   |   |
+   +   +   +   +   +---+   +
|       |       |         T |
+---+---+---+---+---+---+---+
