###############
#O    #       #
##### # # #####
#     # #     #
# ##### ##### #
#   # #     # #
### # ##### # #
# # #     # # #
# # # ### # # #
#   #   #   # #
# ### ####### #
# #   #   #   #
# ##### # # # #
#       #   #T#
###############
