###############
#O#       #   #
# # ##### ### #
# # #   #   # #
# # # # ### # #
#   # #   # # #
##### ##### # #
#   #   #   # #
# ### # # ### #
#     # # #   #
# ##### # ### #
# #   # #     #
# ### # ##### #
#     #      T#
###############
