+---+---+---+---+---+---+---+---+---+---+---+---+---+---+---+---+---+---+---+---+---+---+---+---+---+
| O |               |                                   |                   |       |               |
+   +   +   +---+---+   +---+---+---+   +   +---+   +---+   +   +---+---+   +   +   +---+---+   +   +
|   |   |               |           |   |   |       |       |           |   |   |           |   |   |
+   +---+   +---+---+   +   +---+   +---+   +   +---+   +---+---+---+   +   +   +---+---+   +---+   +
|       |   |       |   |   |       |       |   |   |       |   |       |   |   |       |       |   |
+---+   +---+   +   +   +   +   +---+   +---+   +   +---+   +   +   +---+   +   +   +   +---+   +   +
|   |           |   |   |   |           |               |   |   |   |           |   |       |       |
+   +---+---+---+   +   +   +   +---+---+---+---+---+---+   +   +   +   +---+---+   +   +---+---+   +
|               |   |   |   |   |                       |       |   |   |       |   |               |
+   +   +---+---+   +---+   +   +   +---+---+---+---+   +   +---+   +---+   +   +   +---+---+---+---+
|   |           |   |       |   |   |               |       |       |       |   |   |           |   |
+   +---+---+   +   +   +---+---+   +   +---+---+   +---+---+   +   +   +---+   +   +---+   +   +   +
|   |       |       |           |   |           |   |       |   |   |   |   |   |   |       |   |   |
+   +   +---+---+---+---+---+   +   +---+---+   +   +---+   +   +---+   +   +   +   +   +---+   +   +
|   |                       |   |       |       |           |               |   |       |   |       |
+   +---+---+---+---+   +   +   +---+   +   +---+---+---+---+---+   +---+---+   +---+---+   +---+   +
|                   |   |           |       |           |       |   |   |       |               |   |
+---+---+---+---+   +   +---+   +---+---+   +   +---+   +   +   +   +   +   +   +---+---+   +   +   +
|       |       |   |       |   |           |   |           |   |       |   |   |       |   |   |   |
+   +   +   +   +   +   +   +---+   +---+---+   +---+---+---+   +---+   +   +---+   +   +   +---+   +
|   |   |   |       |   |       |       |       |       |       |       |           |   |   |       |
+   +---+   +---+---+   +---+   +---+   +   +---+   +   +   +---+   +---+---+---+---+   +   +   +---+
|           |   |       |           |   |           |   |       |           |   |       |           |
+   +---+---+   +   +---+   +   +---+   +---+---+---+   +---+   +---+---+   +   +   +---+---+---+   +
|       |       |   |   |   |   |       |           |   |   |   |           |   |   |       |   |   |
+---+   +---+   +   +   +   +---+   +---+---+   +   +   +   +   +---+   +---+   +   +   +   +   +   +
|   |       |           |       |           |   |   |   |           |           |   |   |   |   |   |
+   +---+   +---+---+   +---+   +---+---+   +   +   +   +---+---+   +---+---+   +   +   +   +   +   +
|       |           |       |                   |   |       |           |       |   |   |   |       |
+   +---+---+---+   +   +---+---+---+---+---+---+   +---+   +---+---+   +---+   +   +   +   +---+---+
|   |           |   |   |           |           |       |           |       |   |       |           |
+   +   +---+   +   +   +   +---+   +   +---+   +---+---+---+   +   +---+   +---+---+---+---+---+   +
|   |       |       |   |       |       |   |       |       |   |   |   |                           |
+   +---+   +---+---+---+---+   +---+---+   +---+   +   +   +---+   +   +---+---+---+---+---+---+   +
|   |       |                   |               |       |           |       |               |       |
+   +   +---+   +---+---+---+---+   +   +---+---+---+---+---+---+---+---+   +   +---+---+   +   +---+
|       |               |   |       |                                   |   |   |       |       |   |
+   +---+---+   +---+   +   +   +---+---+---+---+---+---+---+   +---+   +   +   +   +---+---+---+   +
|           |   |       |       |                           |   |           |   |                   |
+---+---+   +---+   +---+   +---+   +---+---+---+---+   +---+   +   +---+---+   +   +---+   +---+   +
|           |       |               |       |           |       |       |       |       |       |   |
+   +---+---+   +---+---+---+---+---+   +---+   +---+---+   +---+---+---+   +---+---+   +---+   +   +
|           |                   |       |       |       |                   |               |   |   |
+---+---+   +---+---+---+---+   +   +   +   +---+---+   +---+---+---+---+---+   +---+---+   +   +   +
|       |                       |   |   |               |           |       |   |       |   |   |   |
+   +   +---+---+---+---+---+---+   +---+---+---+---+   +   +---+   +   +   +   +   +   +   +   +---+
|   |                               |               |       |       |   |   |   |   |   |   |       |
+   +   +---+---+---+---+---+---+---+   +---+   +---+---+---+   +---+   +   +---+   +   +---+---+   +
|   |                                       |                           |           |             T |
+---+---+---+---+---+---+---+---+---+---+---+---+---+---+---+---+---+---+---+---+---+---+---+---+---+
