+---+---+---+---+---+---+---+---+---+---+---+---+---+---+---+---+---+---+---+---+---+---+---+---+---+
| O         |   |           |               |                   |                   |       |       |
+---+---+   +   +   +---+   +   +   +---+   +---+---+   +---+   +---+   +---+---+---+   +   +   +   +
|           |   |       |   |   |       |               |   |   |       |           |   |       |   |
+   +---+---+   +---+   +   +   +---+   +---+   +---+---+   +   +   +---+   +---+   +   +---+---+   +
|   |               |   |   |       |   |       |       |           |       |   |               |   |
+   +   +---+---+---+   +   +---+   +   +---+---+   +   +---+---+   +   +---+   +---+---+---+---+   +
|   |                   |   |       |   |           |       |       |               |       |       |
+   +---+---+---+---+   +   +   +---+   +   +---+---+---+   +---+---+---+---+---+   +   +   +   +   +
|   |       |       |   |   |   |   |               |       |               |       |   |       |   |
+   +   +   +   +   +---+   +   +   +---+---+---+---+   +---+   +   +---+---+   +---+   +---+---+---+
|   |   |       |           |   |       |           |   |       |       |       |   |               |
+   +   +---+---+---+---+---+   +---+   +   +---+   +   +   +---+---+   +   +---+   +---+---+   +   +
|   |                       |           |   |           |       |   |   |   |       |       |   |   |
+   +   +---+---+---+---+   +---+---+   +   +   +---+---+---+   +   +   +   +---+   +   +   +---+   +
|   |       |           |       |       |   |   |           |       |       |       |   |           |
+   +---+   +   +   +---+   +   +   +---+   +   +   +---+   +---+   +---+---+   +---+   +---+---+   +
|   |           |   |       |   |   |   |   |   |   |           |           |   |       |           |
+   +---+---+---+---+   +   +---+   +   +   +   +   +   +---+---+---+---+   +   +   +   +---+---+---+
|   |           |       |   |       |   |   |   |   |       |           |   |   |   |   |           |
+   +   +---+   +   +   +---+   +---+   +   +---+   +---+   +   +   +   +   +   +   +---+   +---+   +
|       |   |   |   |   |       |       |       |       |       |   |   |   |   |           |       |
+---+---+   +   +   +---+   +---+   +---+---+   +   +---+---+---+   +   +   +   +---+---+---+   +---+
|       |       |   |       |       |       |       |               |   |                   |       |
+   +---+   +---+   +   +---+   +   +   +   +---+---+   +---+---+---+---+---+   +---+---+---+   +   +
|       |   |   |       |       |       |           |                           |           |   |   |
+---+   +   +   +   +---+---+---+---+---+   +   +---+---+---+---+---+---+---+---+   +---+   +---+   +
|       |   |   |                       |   |   |                           |       |   |       |   |
+   +---+   +   +---+---+---+---+---+   +   +   +   +---+---+---+---+---+   +   +---+   +---+   +   +
|       |   |                       |   |   |       |       |               |       |               |
+---+   +   +   +---+---+---+---+   +   +---+---+---+   +   +   +---+---+   +---+   +---+---+---+   +
|       |   |       |   |       |               |       |   |   |       |       |               |   |
+   +---+   +---+   +   +   +   +---+---+---+   +   +---+   +   +   +   +---+---+---+---+   +   +   +
|       |   |           |   |           |       |   |       |   |   |                   |   |   |   |
+   +   +   +---+---+---+   +---+---+   +   +---+   +   +---+   +   +---+---+---+---+   +---+   +   +
|   |   |               |   |       |   |   |       |   |       |   |                           |   |
+---+   +---+---+---+   +   +   +---+   +   +---+   +   +   +   +   +---+   +---+---+---+---+---+   +
|                   |       |   |       |           |       |   |       |   |               |   |   |
+   +---+---+---+   +---+---+   +   +---+---+---+---+   +---+---+---+   +---+   +---+---+   +   +   +
|   |       |   |   |   |           |                   |           |       |   |       |   |       |
+   +   +   +   +   +   +   +---+---+   +---+---+---+   +   +---+   +   +   +   +---+   +   +   +---+
|       |   |   |   |   |   |           |           |   |       |   |   |   |           |   |       |
+---+---+   +   +   +   +   +   +---+---+   +---+   +---+---+   +   +---+   +---+---+   +   +---+   +
|       |   |       |   |   |   |   |       |   |       |       |       |           |   |   |       |
+   +   +   +   +---+   +   +   +   +   +---+   +---+   +   +---+---+   +   +---+   +   +   +   +---+
|   |       |           |   |       |       |           |       |   |   |       |   |   |   |   |   |
+   +---+---+---+---+   +   +---+---+---+   +   +---+---+---+   +   +   +---+   +---+   +   +   +   +
|   |       |           |           |       |       |           |   |       |           |   |       |
+   +   +   +---+---+---+---+---+   +   +---+---+   +---+   +---+   +---+   +---+---+---+   +---+   +
|       |                               |                   |                               |     T |
+---+---+---+---+---+---+---+---+---+---+---+---+---+---+---+---+---+---+---+---+---+---+---+---+---+
