###################################################
#O#       #                 #         #   #       #
# # # ##### ####### # ### ### # ##### # # ##### # #
# # #       #     # # #   #   #     # # #     # # #
# ### ##### # ### ### # ### ####### # # ##### ### #
#   # #   # # #   #   # # #   # #   # # #   #   # #
### ### # # # # ### ### # ### # # ### # # # ### # #
# #     # # # #     #       # # # #     # #   #   #
# ####### # # # ############# # # # ##### # ##### #
#       # # # # #           #   # # #   # #       #
# # ##### ### # # ######### # ### ### # # #########
# #     # #   # # #       #   #   #   # # #     # #
# ##### # # ##### # ##### ##### # # ### # ### # # #
# #   #   #     # #     # #   # # # # # # #   # # #
# # ########### # ##### # ### # ### # # # # ### # #
# #           # #   #   #     #       # #   # #   #
# ######### # # ### # ########### ##### ##### ### #
#         # #     #   #     #   # # #   #       # #
######### # ### ##### # ### # # # # # # ##### # # #
#   #   # #   # #     # #     # #   # # #   # # # #
# # # # # # # ### ##### ####### ### # ### # # ### #
# # # #   # #   #   #   #   #   #   #     # # #   #
# ### ##### ### ### # ### # # ### ######### # # ###
#     # #   #     # #     # #   #     # #   #     #
# ##### # ### # ### ####### ### ##### # # ####### #
#   #   # # # # #   #     # # # #     # # #   # # #
### ### # # # ### ##### # # # # ### ### # # # # # #
# #   #     #   #     # # # #     #     # # # # # #
# ### ##### ### ##### # # # ##### ##### # # # # # #
#   #     #   #         # #   #     #   # # # #   #
# ####### # ############# ### ##### ### # # # #####
# #     # # #     #     #   #     #   # #   #     #
# # ### # # # ### # ### ####### # ### ########### #
# #   #   # #   #   # #   #   # # # #             #
# ### ######### ##### ### # # ### # ############# #
# #   #         #       #   #     #   #       #   #
# # ### ######### # ################# # ##### # ###
#   #       # #   #                 # # #   #   # #
# ##### ### # # ############### ### # # # ####### #
#     # #   #   #             # #     # #         #
##### ### ### ### ######### ### # ##### # ### ### #
#     #   #       #   #     #   #   #   #   #   # #
# ##### ########### ### ##### ####### ##### ### # #
#     #         #   #   #   #         #       # # #
##### ######### # # # ##### ########### ##### # # #
#   #           # # #       #     #   # #   # # # #
# # ############# ######### # ### # # # # # # # ###
# #               #       #   #   # # # # # # #   #
# # ############### ### ####### ### # ### # ##### #
# #                   #             #     #      T#
###################################################
