###################################################
#O#         #             #             #   #     #
# ##### ### # # ######### ##### # ##### # # ##### #
# #     # # # #       # #   #   # #   #   # #     #
# # ##### # # ####### # ### # ##### # ##### # ### #
#   #     # #       # #       #     #     #   #   #
####### ### ####### # ######### ######### #########
#     # #   #   #   #           #       # #       #
# ### # # ### # ##### ########### ##### # # ##### #
# #     # #   #     # #         # #   #   #   #   #
# ####### # ####### # # # # ##### # ### ### ### # #
#       #   # #   # # # # # #   # # #   #   #   # #
# ##### ##### # # # # ### # # # # # # ### ### ### #
# # #   # #     #   #     # # #   #     # # #   # #
# # # # # # ############# ### ##### ##### # ### ###
#   # #   #     #   #   # #   #     #   #   # #   #
### # ######### # # # # # # ### ##### # ### # ### #
#   # #       #   #   # # # #   #     #     #   # #
# ### # ##### ######### # # ### # ############# # #
# # #   #   #         # # #   # # #       #     # #
# # ##### # ####### # # # ### ### ### ### # ##### #
# # #   # #         # # #   #       #   #   #     #
# # # # # ### ##### ### ########### ### ### # ### #
#   # # # #   #   # #   #         #     # # #   # #
### # # # ##### # # # ### ####### ####### # ### ###
#   # #   #   # # # #   # #     # #     # # # #   #
# ### ##### # # # # ### # # ##### # ### # # # ### #
#   #       # # # #   #   # #     # #   #       # #
### ######### # # ######### # ##### ### ### ##### #
# #   #   #   # #   #         # #     #   # #   # #
# ### # ### ### ### # ######### # ### ### ### # # #
# #   #   #     #   #   #     #   #   # # #   #   #
# # ##### ####### ##### # ### ### # ### # # ##### #
# #       #     #     #   # #   # # #   # # #   # #
# ####### ##### ### ####### ### # # # ### # # ### #
#   #   #   #     #     #     # # # #       # #   #
# # # # ### # ### ### # ##### # ### # ####### # ###
# #   # #   # #   # # #       #   # #   #   #   # #
# ####### ### # ### # ########### # ##### # # ### #
# #   #   #   #     # #       #   # #   # # #   # #
# # # # ### ####### # # ##### # ### # # # # ### # #
# # #   #   #   #   # #     #   #     #   # #     #
# # ##### ### # # ### ##### ############# # #######
# # #   # #   #     #   #   #     #     # #       #
# # # # # # ######### # # ### ### # ### ##### ### #
#   # #   # #     #   # #     #   # # #     # #   #
# ### ##### ##### # ########### ### # ##### ### ###
# #       #   #   # #         # #   #     #   #   #
# ####### ### # # # # ####### # ### # ####### ### #
#         #     # #         #       #            T#
###################################################
