+---+---+---+---+---+---+---+---+---+---+---+---+---+---+---+---+---+---+---+---+---+---+---+---+---+
| O |                   |                           |                           |       |           |
+   +---+---+   +---+   +   +   +---+---+---+---+   +---+---+   +   +---+---+   +   +   +---+---+   +
|   |           |   |   |   |               |   |       |       |   |       |       |   |           |
+   +   +---+---+   +   +   +---+---+---+   +   +---+   +   +---+---+   +   +---+---+   +   +---+   +
|       |           |   |               |   |               |           |           |       |       |
+---+---+---+   +---+   +---+---+---+   +   +---+---+---+---+   +---+---+---+---+   +---+---+---+---+
|           |   |       |       |       |                       |               |   |               |
+   +---+   +   +   +---+   +   +---+---+   +---+---+---+---+---+   +---+---+   +   +   +---+---+   +
|   |           |   |       |           |   |                   |   |       |       |       |       |
+   +---+---+---+   +   +---+---+---+   +   +   +   +   +---+---+   +   +---+   +---+   +---+   +   +
|               |       |   |       |   |   |   |   |   |       |   |   |       |       |       |   |
+   +---+---+   +---+---+   +   +   +   +   +---+   +   +   +   +   +   +   +---+   +---+   +---+   +
|   |   |       |   |           |       |           |   |   |       |           |   |   |       |   |
+   +   +   +   +   +   +---+---+---+---+---+---+   +---+   +---+---+   +---+---+   +   +---+   +---+
|       |   |       |           |       |       |   |       |           |       |       |   |       |
+---+   +   +---+---+---+---+   +   +   +   +   +   +   +---+   +---+---+   +   +---+   +   +---+   +
|       |   |               |       |       |   |   |   |       |           |           |       |   |
+   +---+   +   +---+---+   +---+---+---+---+   +   +   +---+   +   +---+---+---+---+---+---+   +   +
|   |   |       |       |                   |   |   |       |   |   |               |           |   |
+   +   +---+---+   +   +---+---+---+   +   +   +   +---+   +---+   +---+   +---+   +   +---+---+   +
|   |   |       |   |                   |   |   |       |               |       |       |           |
+   +   +   +   +   +---+   +---+---+   +---+   +---+---+---+---+---+   +---+   +---+   +   +---+   +
|       |   |   |   |       |       |   |       |                   |           |   |   |       |   |
+---+   +   +   +   +---+---+   +   +   +   +---+   +---+---+---+   +---+---+---+   +   +---+   +---+
|       |   |       |       |   |   |   |       |   |           |   |           |   |   |   |       |
+   +---+   +---+---+   +   +   +   +   +---+   +   +   +---+---+   +   +---+   +   +   +   +---+   +
|       |               |   |   |   |       |       |   |           |   |       |               |   |
+---+   +---+---+---+---+   +   +   +---+---+---+---+   +   +---+---+   +---+   +---+   +---+---+   +
|   |       |       |       |   |       |                   |   |           |       |   |       |   |
+   +---+   +   +---+   +---+   +---+   +   +---+---+---+---+   +   +---+   +---+   +---+   +   +   +
|   |       |       |           |       |       |           |       |       |   |   |       |       |
+   +   +---+---+   +---+---+---+   +---+---+   +   +---+   +---+   +   +---+   +   +   +---+---+   +
|   |               |           |           |       |   |       |   |   |       |   |   |       |   |
+   +---+---+---+   +---+---+   +---+   +---+---+---+   +---+   +   +   +   +---+   +   +   +---+   +
|       |       |       |           |           |           |   |   |   |               |   |       |
+   +   +   +   +---+   +   +---+   +---+   +   +---+---+   +   +---+   +   +---+---+---+   +   +---+
|   |       |   |       |   |       |   |   |               |       |   |       |       |       |   |
+   +---+---+---+   +---+   +   +---+   +   +---+---+---+---+---+   +   +---+---+   +   +   +---+   +
|   |       |       |       |           |   |               |       |   |       |   |   |       |   |
+   +   +   +   +---+   +---+---+---+   +   +   +---+---+   +   +---+   +   +   +   +   +---+   +   +
|   |   |       |       |       |       |   |           |       |           |       |   |           |
+   +   +---+---+   +---+   +   +   +---+   +---+---+   +---+---+---+---+---+---+   +   +---+---+---+
|   |   |       |   |       |           |       |       |           |           |   |               |
+   +   +   +   +   +   +---+---+---+---+   +   +   +---+   +---+   +   +---+   +---+---+   +---+   +
|       |   |       |   |           |       |   |           |       |   |   |           |   |       |
+   +---+   +---+---+   +---+---+   +   +---+---+---+---+---+   +---+   +   +---+---+   +---+   +---+
|   |               |       |       |   |                   |   |       |           |       |       |
+   +---+---+---+   +---+   +   +   +   +   +---+---+---+   +   +---+   +   +---+---+---+   +---+   +
|                   |           |   |                   |               |                         T |
+---+---+---+---+---+---+---+---+---+---+---+---+---+---+---+---+---+---+---+---+---+---+---+---+---+
