###############################
#S  #   #   #     #           #
### # # # ### # ### ### ##### #
# #   # #     #     #   #   # #
# ##### # ######### # ### # ###
# #     # # #     # #     #   #
# # ##### # # ### # ####### # #
#   #   #   # # # #   #   # # #
# ### # # ### # # ##### # # # #
#   # #   #   # #       # # # #
### ####### ### ######### # # #
# #     #   #           # # # #
# ##### # ### ### ##### # ### #
# #   # # #     #     # #   # #
# # # # # ########### ##### # #
# # #   #           #     #   #
# # ##### ######### # ### ### #
# #   #     #   #   #   #   # #
# ### ##### # # # ##### ### # #
#   #   #   # # # #   # # #   #
# # ### # ### ### # ### # #####
# # #   #     #   #   # #     #
# # # ##### ### ##### # # ### #
# # # #   # #   #     #   #   #
# ### # ### # ##### # ##### ###
# #   # #   #   #   # #   # # #
# # ### # ##### # ##### # # # #
# # #     #     #     # # #   #
# # ####### ##### ### # # ### #
#           #       #   #    E#
###############################
