#############
#S#   #     #
# ### # ### #
#   #     # #
### ####### #
# # #     # #
# # # ### # #
# #   #   # #
# ##### ### #
#     # #   #
# # ### # # #
# #       #E#
#############
