#######
#S#   #
# # # #
# # # #
# ### #
#    E#
#######
