###########
#O  #     #
### ##### #
# #   #   #
# ### # ###
#     #   #
# ####### #
# #     # #
# # ### # #
#   #    T#
###########
