###########
#O#   #   #
# # # # ###
#   # #   #
##### ### #
#   #     #
# # ##### #
# #   #   #
# ##### ###
#        T#
###########
