+---+---+---+---+---+
| O     |           |
+---+   +   +---+   +
|   |   |       |   |
+   +   +---+   +   +
|   |           |   |
+   +---+---+---+   +
|       |       |   |
+   +   +   +   +   +
|   |       |     T |
+---+---+---+---+---+
