+---+---+---+---+---+
| O |       |       |
+   +   +   +   +---+
|       |   |       |
+---+---+   +---+   +
|       |           |
+   +   +---+---+   +
|   |       |       |
+   +---+---+   +---+
|                 T |
+---+---+---+---+---+
