+---+---+---+---+---+
| O     |           |
+---+   +---+---+   +
|   |       |       |
+   +---+   +   +---+
|           |       |
+   +---+---+---+   +
|   |           |   |
+   +   +---+   +   +
|       |         T |
+---+---+---+---+---+
