###########
#O  #     #
### # ### #
# # #   # #
# # ### # #
# #     # #
# ####### #
#   #   # #
# # # # # #
# #   #  T#
###########
