###############################
#S  #             #           #
### # # ########### ######### #
#   # #         #         # # #
# ### ######### # ####### # # #
#   #     #   #   #   #     # #
### ### ### # # ### # ####### #
# # #   #   # # #   # #     # #
# # ##### ### # # ### # ### # #
# #       # # # # # #   # #   #
# ######### # ### # ##### ### #
# #         # #   #         # #
# # ### ##### # ### ####### # #
# # # #   #   #   # #   # # # #
# # # ### # ### # # # # # # # #
# # #   #   #   # # # #   #   #
# # # ########### # # ### #####
#   #   #       # #   #       #
# ### # # # ### # ########### #
#   # #   # #     #     #   # #
### ####### ####### ### # # ###
#   #     #       # # #   #   #
# ### ### ##### # # # ####### #
#   # #       # #     #       #
### # ####### ####### # #######
#   #   #   #       # #       #
# ##### # # ####### # ####### #
#   #   # # #     # # #       #
### # ### ### ### # ### ##### #
#     #         #       #    E#
###############################
