+---+---+
| O     |
+---+   +
|     T |
+---+---+
