#################################
#O    #   #   #     #   #       #
##### # # # # ### # # # # #######
#   #   #   #     #   # #       #
# ##################### ####### #
# #         #       # #         #
# # # ##### # ### # # ######### #
# # # #     #   # #     #     # #
# # # ####### ### ##### # ### # #
#   # #     # #   #     # # #   #
# ### # ### # # # ####### # #####
# #   #   #   # # #       #     #
# # # ### ##### ### ####### #####
# # #   # #   # #   # #   #     #
### ### # # # # # ### # # # ### #
#   #   #   # # #   # # #     # #
# ##### ##### # ### # # ####### #
#     #   #   #   # #     #     #
# ### ##### ##### # ####### ### #
#   #   #   #   # #   #     #   #
### ### # ### # # ### # #########
#   #   # #   # #     #         #
# ### ### # ### ####### ####### #
# # #     # #   #   #     #     #
# # ######### # ### # ##### #####
# #         # #   #   #   # #   #
# ##### ### # ### ##### # # # # #
#     #   #   # #       # #   # #
##### # # ##### ######### # ### #
#     # # #   #       #   # #   #
# ####### # # # ### ### ##### # #
#         # #     #           #T#
#################################
