#################################
#O#             #   #   #   #   #
# ### ### ##### # # # # # # ### #
#   # #   #   #   # # #   #   # #
### # # ### # ##### # ####### # #
#   # # #   #   # #   #     # # #
# ### # # ##### # ##### # ### # #
#   # # # #       # #   #     # #
### ### # ####### # # ######### #
# #     #     #   # # #         #
# ######### # # ### # ### ##### #
#         # # # #   #     #   # #
# ### ### ### # ### ####### # # #
# #   # # #   #         #   #   #
# # ### # # ############# #######
# # #   #   #     #     #   #   #
# # # # ### # ### # ### ### ### #
# # # #   # #   # #   #   # #   #
# # # # ### ### # ### ### # # # #
# # # #       # #     # # #   # #
# # # ####### # ####### # ##### #
# # #   #   # # #       #     # #
# # # ### # ### # ### ####### # #
# # # #   #     #   #   #     # #
# # ### ######### ##### # ### # #
# # #   #       # #     # #   # #
### # ##### ### # # ##### ##### #
#   #   #   #   # #   #   #     #
# ##### # ### ####### # ### #####
# #     # # #   #   # #   #     #
# # ##### # ### # # # ### ##### #
#         #       #     #      T#
#################################
