+---+---+---+---+---+---+---+---+---+---+---+---+---+---+---+---+
| O     |           |                                           |
+---+   +---+   +   +---+---+   +---+---+---+---+---+---+---+   +
|   |   |       |               |               |               |
+   +   +   +---+---+---+---+---+   +---+---+   +   +---+---+---+
|   |       |       |           |   |           |   |       |   |
+   +---+---+---+   +   +---+   +   +   +---+   +   +   +   +   +
|                   |   |   |       |   |       |       |   |   |
+   +---+---+---+---+   +   +---+---+   +---+---+---+---+   +   +
|   |       |       |       |   |       |                   |   |
+   +   +   +   +   +---+   +   +   +   +   +---+---+---+---+   +
|       |       |       |       |   |   |                   |   |
+   +---+---+---+   +---+---+   +   +---+---+---+---+---+   +   +
|   |       |   |               |           |   |           |   |
+   +   +   +   +---+---+---+---+---+   +   +   +   +---+---+   +
|   |   |       |       |           |   |       |           |   |
+   +   +---+   +   +---+   +---+   +   +---+---+---+---+   +   +
|   |       |       |       |   |   |               |       |   |
+   +   +   +---+---+   +---+   +   +---+---+   +   +   +---+   +
|   |   |                       |   |           |   |           |
+   +   +---+---+---+---+---+---+   +   +---+---+   +---+---+   +
|   |       |                   |   |   |       |   |       |   |
+   +---+   +   +---+---+---+   +   +   +---+   +   +---+   +   +
|       |   |   |       |   |       |   |       |   |       |   |
+---+   +---+   +   +   +   +---+   +   +   +---+   +   +---+   +
|   |           |   |       |       |   |               |       |
+   +---+---+---+   +---+   +   +---+   +   +---+---+---+   +---+
|       |           |       |   |   |   |       |           |   |
+   +   +---+   +---+   +---+   +   +   +---+---+   +---+---+   +
|   |           |       |       |   |   |       |   |           |
+   +---+---+---+---+---+   +---+   +   +   +   +   +---+---+   +
|                                   |       |                 T |
+---+---+---+---+---+---+---+---+---+---+---+---+---+---+---+---+
