+---+---+---+---+---+---+---+---+---+---+---+---+---+---+---+---+
| O |                           |       |       |       |       |
+   +---+   +---+   +---+---+   +   +   +   +   +   +   +---+   +
|       |   |       |       |       |   |   |       |       |   |
+---+   +   +   +---+   +   +---+---+   +   +---+---+---+   +   +
|       |   |   |       |       |   |       |           |   |   |
+   +---+   +   +   +---+---+   +   +---+---+   +   +---+   +   +
|       |   |   |   |               |   |       |           |   |
+---+   +---+   +   +---+---+---+   +   +   +---+---+---+---+   +
|   |           |           |       |   |   |                   |
+   +---+---+---+---+   +   +   +---+   +   +---+   +---+---+   +
|                   |   |   |   |       |           |       |   |
+   +---+   +---+   +---+   +   +---+   +---+---+---+   +   +   +
|   |       |   |   |       |                   |       |       |
+   +   +---+   +   +   +---+---+---+---+---+---+   +---+---+---+
|   |   |       |       |           |           |       |       |
+   +   +   +   +---+   +   +---+   +   +---+   +---+   +---+   +
|   |   |   |       |   |       |   |       |       |   |       |
+   +   +   +   +---+   +---+   +   +---+   +---+   +   +   +   +
|   |   |   |               |   |           |   |   |       |   |
+   +   +   +---+---+---+   +   +---+---+---+   +   +---+---+   +
|   |   |       |       |   |   |               |           |   |
+   +   +   +---+   +   +---+   +   +---+   +---+---+---+   +   +
|   |   |   |       |           |       |       |           |   |
+   +   +---+   +---+---+---+---+   +---+---+   +   +---+   +   +
|   |   |       |               |   |           |   |       |   |
+---+   +   +---+---+   +---+   +   +   +---+---+   +---+---+   +
|       |       |       |       |   |       |       |           |
+   +---+---+   +   +---+   +---+---+---+   +   +---+   +---+---+
|   |           |   |   |       |       |   |       |           |
+   +   +---+---+   +   +---+   +   +   +   +---+   +---+---+   +
|                   |               |           |             T |
+---+---+---+---+---+---+---+---+---+---+---+---+---+---+---+---+
