#################################
#O  #     #                     #
### ### # ##### ############### #
# # #   #       #       #       #
# # # ########### ##### # #######
# #   #   #     # #     # #   # #
# ####### # ### # # ### # # # # #
#         # # #   # #   #   # # #
# ######### # ##### ######### # #
# #   #   #   # #   #         # #
# # # # # ### # # # # ######### #
#   #   #   #   # # #         # #
# ####### ##### # ########### # #
# #   # #       #     # #     # #
# # # # ########### # # # ##### #
# # #   #   #     # #   #     # #
# # ### # ### ### # ######### # #
# #   #   #   # # #       #   # #
# # # ##### ### # ##### # # ### #
# # #           # #     # #     #
# # ############# # ##### ##### #
# #   #         # # #   # #   # #
# ### # ####### # # ### # ### # #
#   # # #   # #   # #   # #   # #
### ### # # # ### # # ### # ### #
# #     # #   #   # #       #   #
# ####### ### # ### # ####### ###
#   #     #   # # # #   #     # #
# # ### ### ### # # ##### ##### #
# #     #   #   # # #   # #     #
# ########### ### # # # # ##### #
#                 #   #        T#
#################################
