+---+---+---+---+---+---+---+---+---+---+---+---+---+---+---+---+
| O         |       |       |           |       |               |
+---+---+   +   +   +   +   +---+   +   +   +   +   +---+---+---+
|       |       |       |           |       |   |               |
+   +---+---+---+---+---+---+---+---+---+---+   +---+---+---+   +
|   |                   |               |   |                   |
+   +   +   +---+---+   +   +---+   +   +   +---+---+---+---+   +
|   |   |   |           |       |   |           |           |   |
+   +   +   +---+---+---+   +---+   +---+---+   +   +---+   +   +
|       |   |           |   |       |           |   |   |       |
+   +---+   +   +---+   +   +   +   +---+---+---+   +   +---+---+
|   |       |       |       |   |   |               |           |
+   +   +   +---+   +---+---+   +---+   +---+---+---+   +---+---+
|   |   |       |   |       |   |       |   |       |           |
+---+   +---+   +   +   +   +   +   +---+   +   +   +   +---+   +
|       |       |       |   |   |       |   |   |           |   |
+   +---+---+   +---+---+   +   +---+   +   +   +---+---+---+   +
|           |       |       |       |   |           |           |
+   +---+   +---+---+   +---+---+   +   +---+---+---+   +---+   +
|       |       |       |       |   |       |           |       |
+---+   +---+   +   +---+   +   +   +---+   +   +---+---+---+---+
|       |       |   |       |   |           |                   |
+   +---+   +---+   +   +---+   +---+---+---+   +---+---+---+   +
|   |   |           |   |       |       |           |           |
+   +   +---+---+---+---+   +   +---+   +   +---+---+   +---+---+
|   |                   |   |       |       |       |   |       |
+   +---+---+   +---+   +   +---+   +---+---+   +   +   +   +   +
|           |       |       |   |               |   |       |   |
+---+---+   +   +   +---+---+   +---+---+---+---+   +   +---+   +
|           |   |   |       |               |       |   |       |
+   +---+---+---+   +   +   +   +---+   +---+   +---+---+   +   +
|                   |   |           |                       | T |
+---+---+---+---+---+---+---+---+---+---+---+---+---+---+---+---+
