#############
#S#     #   #
# ### # # # #
#     # # # #
####### ### #
# #   # #   #
# # # # # ###
#   #   #   #
# ######### #
# #         #
# ### ##### #
#     #    E#
#############
