###########
#O  #     #
### ### ###
# #   #   #
# ### ### #
# #   #   #
# # ### # #
# #     # #
# ####### #
#        T#
###########
