+-+-+-+-+-+
|O  |     |
+-+ +-+ +-+
| |   |   |
+ +-+ +-+ +
| |   |   |
+ + +-+ + +
| |     | |
+ +-+-+-+ +
|        T|
+-+-+-+-+-+
