+-+-+-+-+-+-+
|S|   |     |
+ +-+ + +-+ +
|   | | |   |
+-+ + + + + +
| | |   | | |
+ + +-+-+ +-+
| |     |   |
+ +-+-+ +-+ +
|   |   |   |
+ + + +-+ + +
| |       |E|
+-+-+-+-+-+-+
