#############
#S#   #     #
# ### # ### #
#   # # #   #
### # # # # #
# # #   # # #
# # ##### ###
# #     #   #
# ##### ### #
#   #   #   #
# # # ### # #
# #       #E#
#############
