#############################
#O#     #     #             #
# # ### ##### # ####### ### #
#   # #     #         # #   #
##### ##### ####### ### #####
#       # #   #   # #   #   #
# ##### # ### # # ### # # # #
# #   #     # # #     # # # #
# ### ##### # # ######### # #
#   # #     # #     #     # #
# # # # ##### ##### # ##### #
# # #   #   # #   #       # #
# # # ### # # # # ######### #
# # # #   # #   # #   #   # #
### # ##### ##### # # # # # #
#   #     # #   #   #   # # #
# ####### # # # ######### # #
#     #     # #       #   # #
# ### ####### ##### ### ### #
# # #   #   # #   #     #   #
# # ### # # # # # ####### # #
# #   #   #   # #   #     # #
# # ########### ### ##### ###
# #         #   # # #   #   #
# ### ##### # # # # # # # # #
#     # #   # # #   # # # # #
####### # ##### # ### # ### #
#               #     #    T#
#############################
