+---+---+---+---+---+---+---+---+---+---+---+---+---+---+
| O |           |           |                           |
+   +   +---+   +---+---+   +   +---+---+---+   +---+   +
|       |   |           |                   |   |       |
+---+---+   +---+---+   +---+---+---+   +---+   +---+---+
|               |   |       |       |   |       |       |
+   +---+---+   +   +---+   +   +   +---+   +   +   +   +
|   |       |           |   |   |           |   |   |   |
+   +---+   +---+---+   +   +   +---+---+---+---+   +   +
|       |   |           |   |           |           |   |
+   +   +   +   +---+---+   +---+---+   +   +---+---+   +
|   |   |       |       |   |       |               |   |
+   +   +   +---+   +   +   +   +   +---+---+---+---+   +
|   |   |   |       |   |       |   |       |       |   |
+---+   +   +---+---+   +---+---+   +   +   +   +   +   +
|       |           |   |       |       |       |   |   |
+   +---+---+---+   +   +   +   +---+---+---+---+   +   +
|           |           |   |               |       |   |
+   +---+   +---+---+---+   +---+---+   +---+   +---+   +
|   |   |       |       |   |       |           |       |
+   +   +---+   +   +   +   +   +   +---+---+---+   +   +
|   |       |       |       |   |       |           |   |
+   +   +---+---+---+---+---+   +---+   +---+---+   +---+
|   |                   |       |   |   |       |       |
+   +---+   +---+---+   +   +   +   +   +   +   +   +   +
|           |   |       |   |   |       |   |   |   |   |
+---+---+---+   +   +---+---+   +   +---+   +   +---+   +
|                               |           |         T |
+---+---+---+---+---+---+---+---+---+---+---+---+---+---+
