#############################
#O    #     #   #           #
##### # ### # # ### ##### # #
#   #   #   # #   # #   # # #
### ##### ### ### # # # # # #
#       #     # # # # #   # #
# ############# # ### ##### #
#               #   # #   # #
# ####### # ####### # # # ###
# #       # #   #   #   #   #
### ####### # # # ### ##### #
#   #       # # # # # #   # #
# ########### # # # # # ### #
#             #   #     #   #
# ################### ### # #
# #     #           # #   # #
# ##### # ##### ### ### ### #
#     #     # # #     #   # #
##### ##### # # ##### ### # #
#   #   #     #   # #     # #
# ##### ##### ### # ####### #
#     #   #   # # #     #   #
# ### ### # ### # # ##### ###
# # #   # #     # #     #   #
# # # # # ##### # ##### ### #
# # # # # #     # #       # #
# # # ### ####### # ####### #
#   #             #        T#
#############################
