#############################
#O  # #       #         #   #
### # # ### # # ### ### ### #
#   #   #   # #   # #     # #
# ### ### ### ### # ##### # #
# #     # #     # #   # #   #
# ##### # ####### ### # ### #
#   #   #           # #   # #
### ######### ####### ### # #
# #   #     #   #   # #   # #
# ### # ### # ### # # # ### #
#   # #   # # #   #   #   # #
# # # # # # ### ####### # # #
# #   # # #     #     # # # #
# ##### # ####### ##### # # #
#   #   # #       #     # # #
### # ### # ####### ##### # #
# # # #   #       # #   #   #
# # ### ######### # # # #####
# #   #   #     # # # #     #
# ### # # # ### # # ### ### #
#   # # # # #     #     #   #
# # # # # # ############# ###
# #   # # #           #   # #
# ####### ######### # # ### #
#   #   #         # # # #   #
### # # ######### # # # # # #
#     #           # #     #T#
#############################
