+---+---+---+---+---+---+---+---+---+---+---+---+---+---+
| O         |           |       |                       |
+---+---+   +   +---+   +   +   +---+   +---+---+   +   +
|       |       |       |   |       |   |       |   |   |
+---+   +---+---+   +---+   +---+   +   +   +   +   +   +
|               |           |   |   |   |   |       |   |
+   +---+---+---+---+---+---+   +   +---+   +---+---+   +
|                               |       |   |       |   |
+   +---+---+---+   +   +---+---+---+   +   +   +   +---+
|   |               |   |       |       |       |       |
+---+   +---+---+---+   +   +   +   +---+   +---+---+   +
|       |               |   |   |   |   |   |       |   |
+   +---+---+---+---+---+   +   +   +   +   +   +---+   +
|                           |       |           |       |
+   +---+---+---+---+---+---+---+---+---+   +---+   +   +
|   |           |                       |   |       |   |
+   +---+---+   +   +---+---+   +---+   +---+   +---+   +
|           |           |   |   |           |       |   |
+---+---+   +---+---+   +   +   +---+---+   +---+   +   +
|       |       |           |       |   |           |   |
+   +---+---+   +---+---+   +---+   +   +---+---+---+   +
|           |       |       |   |   |           |       |
+   +---+   +---+   +   +---+   +   +   +---+---+   +---+
|   |   |       |   |           |   |           |       |
+   +   +   +   +   +---+---+   +   +---+---+   +---+   +
|   |   |   |   |   |           |   |               |   |
+   +   +   +---+   +---+---+---+   +   +---+---+---+   +
|       |                           |                 T |
+---+---+---+---+---+---+---+---+---+---+---+---+---+---+
