+-+-+-+-+-+-+
|S|     |   |
+ +-+ + + +-+
|     | |   |
+-+-+-+ + + +
| |     | | |
+ + +-+-+-+ +
| | |   |   |
+ + + + + + +
|   | |   | |
+ +-+ +-+-+ +
|     |    E|
+-+-+-+-+-+-+
