+---+---+---+---+---+
| O |               |
+   +   +---+   +   +
|   |       |   |   |
+   +---+---+   +   +
|       |       |   |
+---+   +   +---+   +
|   |   |   |   |   |
+   +   +   +   +   +
|           |     T |
+---+---+---+---+---+
