#######################
#O  #         # #     #
### # ##### # # # ### #
#   #     # #   # #   #
# ####### # ##### # ###
# #     # # #     #   #
# # ### # # # ####### #
#   #   # # # # #     #
##### ### # # # # ### #
#   # #   #     #   # #
# ### # ####### ### # #
#     # #   #     # # #
# ####### # ### ### # #
# #       #   # #   # #
# ### ####### # # ### #
#   # # #   # # # # # #
### # # # # # ### # # #
# #   #   # #   # #   #
# ##### ### ### # # ###
# #   #   #   #   # # #
# # # ### # ####### # #
#   #     #          T#
#######################
