+---+---+---+---+---+---+---+---+---+---+---+
| O     |                   |   |           |
+---+   +   +---+---+   +   +   +   +---+   +
|       |           |   |       |   |       |
+   +---+---+---+   +   +---+---+   +   +---+
|   |           |   |   |           |       |
+   +   +---+   +   +   +   +---+---+---+   +
|       |       |   |   |   |   |           |
+---+---+   +---+   +   +   +   +   +---+   +
|       |   |       |           |       |   |
+   +---+   +   +---+---+---+   +---+   +   +
|           |   |       |           |   |   |
+   +---+---+---+   +   +---+   +---+   +   +
|   |               |       |   |       |   |
+   +---+   +---+---+---+   +   +   +---+   +
|       |   |   |       |   |   |   |   |   |
+---+   +   +   +   +   +   +---+   +   +   +
|   |       |       |   |       |   |       |
+   +---+---+   +---+   +---+   +   +   +---+
|   |       |       |       |       |   |   |
+   +   +   +---+   +   +---+---+---+   +   +
|       |           |                     T |
+---+---+---+---+---+---+---+---+---+---+---+
