+---+---+---+---+---+---+---+---+---+---+---+
| O |               |                   |   |
+   +---+   +---+   +---+   +---+---+   +   +
|           |   |   |       |       |       |
+---+---+---+   +   +   +---+---+   +---+   +
|       |           |   |               |   |
+   +   +   +---+---+   +---+   +---+---+   +
|   |   |   |       |       |           |   |
+   +   +   +   +   +   +   +   +---+   +   +
|   |   |       |   |   |   |       |       |
+   +---+---+---+   +---+   +---+   +---+---+
|               |           |       |       |
+   +---+---+   +---+---+---+   +---+   +   +
|   |       |       |           |       |   |
+   +---+   +   +---+   +---+---+   +---+   +
|   |       |       |   |           |       |
+   +   +---+---+   +   +---+---+---+   +---+
|       |           |       |       |       |
+---+   +   +---+---+---+   +   +   +---+   +
|   |   |           |       |   |   |       |
+   +   +---+---+   +   +---+   +   +   +   +
|               |               |       | T |
+---+---+---+---+---+---+---+---+---+---+---+
