+---+---+---+---+---+---+---+---+---+---+---+
| O |   |                       |           |
+   +   +   +   +---+---+---+   +   +   +---+
|   |       |       |   |       |   |       |
+   +---+---+---+   +   +   +---+---+---+   +
|               |   |   |       |       |   |
+---+---+---+   +   +   +---+   +   +   +   +
|           |       |       |   |   |       |
+   +---+   +---+---+   +---+   +   +---+---+
|   |               |           |   |       |
+   +   +---+---+---+   +---+---+   +   +   +
|   |       |       |   |       |       |   |
+   +---+   +   +   +   +   +   +   +---+   +
|   |   |   |   |       |   |   |   |       |
+   +   +   +   +---+---+   +   +---+   +   +
|   |   |       |           |           |   |
+   +   +---+---+   +---+---+---+---+---+   +
|               |           |           |   |
+---+---+---+   +   +---+   +   +---+---+   +
|           |   |   |       |           |   |
+   +---+---+   +---+   +---+   +---+   +   +
|                       |           |     T |
+---+---+---+---+---+---+---+---+---+---+---+
