#######################
#O#       #         # #
# ### ### ### ##### # #
#     # # #   #   #   #
####### # # ##### ### #
#   #     # #       # #
# # # ##### ### ##### #
# # # #   #   #     # #
# # # # # # # # ### # #
# # #   # # # #   #   #
# ####### ### ### #####
#       #     #   #   #
# ##### ####### ### # #
# #   #   #     #   # #
# ### # ### ##### ### #
# #   #   # #     #   #
# # ##### # ####### ###
#   #     #   #   #   #
### # ####### # # ### #
# # #     #   # # #   #
# # ##### # ### # # # #
#       #       #   #T#
#######################
