+---+---+---+---+---+---+---+---+---+---+---+---+---+---+---+---+---+---+---+---+---+---+---+---+---+---+---+---+---+---+
| O     |           |           |           |                   |                                           |           |
+---+   +---+   +   +   +---+   +   +---+   +   +---+   +---+---+   +---+---+   +   +---+---+---+---+---+   +   +---+   +
|   |           |   |       |       |   |   |   |   |       |       |       |   |       |       |   |       |       |   |
+   +---+---+---+   +   +   +---+---+   +   +   +   +---+   +   +---+   +   +   +---+   +   +   +   +   +---+---+   +   +
|                   |   |       |       |   |   |       |           |   |   |       |       |   |   |           |   |   |
+   +---+---+---+---+   +---+   +   +---+   +   +---+   +---+---+---+   +   +---+---+---+---+   +   +---+---+   +   +   +
|   |               |       |   |           |       |       |           |                       |               |   |   |
+   +---+---+---+   +   +---+   +---+---+   +---+   +   +   +   +---+---+---+---+---+---+---+---+   +---+---+---+---+   +
|               |       |       |       |   |       |   |   |                   |               |       |           |   |
+---+---+---+   +   +---+   +   +   +   +---+   +---+   +   +---+---+---+   +   +---+---+   +   +---+   +   +---+   +   +
|           |   |   |   |   |   |   |       |           |   |           |   |           |   |   |       |       |       |
+   +   +---+   +   +   +   +---+   +---+   +---+   +---+---+   +---+   +---+---+---+   +   +   +   +---+---+   +---+   +
|   |           |   |   |           |   |   |       |           |   |                   |   |   |   |       |   |   |   |
+   +---+---+---+   +   +---+---+---+   +   +   +---+   +---+---+   +---+---+---+---+---+   +   +   +   +   +   +   +   +
|           |       |           |       |           |           |   |       |           |   |       |   |       |   |   |
+---+---+   +   +---+---+   +   +   +   +---+---+   +---+---+   +   +   +   +   +---+   +   +---+---+   +---+---+   +   +
|       |   |               |   |   |   |       |           |   |   |   |       |       |   |           |           |   |
+   +   +   +---+---+---+---+   +   +   +   +   +---+---+---+   +   +   +---+---+   +   +   +---+   +---+---+   +---+   +
|   |   |           |       |   |   |   |   |   |               |       |           |   |           |           |       |
+   +---+---+---+   +   +   +   +   +---+   +   +   +---+---+---+---+   +   +---+---+   +---+---+---+---+   +---+   +---+
|               |   |   |           |       |       |               |   |   |   |       |                   |       |   |
+   +   +---+---+   +---+---+---+   +   +---+---+---+   +---+   +   +---+   +   +   +---+   +---+   +---+---+   +---+   +
|   |   |           |           |   |   |               |       |       |   |   |       |   |       |       |           |
+   +   +   +---+---+   +---+   +   +   +---+   +---+---+   +---+---+   +   +   +   +---+   +   +---+   +   +---+---+   +
|   |   |   |           |       |   |       |           |           |   |   |       |       |           |       |       |
+---+   +   +---+---+   +   +---+---+---+   +---+---+   +---+---+   +   +   +---+---+   +---+---+---+---+   +---+   +---+
|       |               |           |       |       |   |       |   |       |           |               |       |   |   |
+   +   +---+---+---+---+---+---+   +   +---+   +---+   +   +   +   +---+   +   +---+---+---+   +---+   +---+   +   +   +
|   |       |               |       |   |   |           |   |   |       |   |   |               |       |   |   |       |
+   +---+---+   +---+   +---+   +---+   +   +   +---+---+   +   +---+   +---+   +   +---+   +---+   +---+   +   +---+   +
|           |   |   |       |   |       |   |   |           |           |       |       |       |           |       |   |
+   +---+   +   +   +---+   +   +   +---+   +   +   +---+---+---+   +---+   +---+---+   +---+   +---+---+---+   +   +   +
|       |   |           |   |       |           |   |       |       |       |               |       |           |   |   |
+---+   +   +---+   +---+   +---+---+   +---+---+   +   +   +   +---+   +---+---+---+---+---+---+   +   +---+---+   +   +
|       |       |   |               |           |   |   |       |   |   |           |               |   |           |   |
+   +---+   +---+   +   +---+   +---+---+   +---+   +---+---+   +   +   +   +---+   +   +   +---+---+   +   +---+---+   +
|       |           |   |       |           |       |       |       |       |   |       |   |           |       |       |
+---+   +---+---+---+   +---+---+   +---+---+   +---+   +   +---+---+---+---+   +---+---+   +   +   +---+---+---+   +---+
|   |   |   |           |           |       |       |   |                   |               |   |   |               |   |
+   +   +   +   +---+   +   +---+---+   +---+---+   +   +---+---+---+---+   +   +---+---+---+   +---+   +---+---+---+   +
|   |       |   |       |           |   |       |   |   |           |   |       |           |           |               |
+   +---+   +   +   +---+---+---+   +   +   +   +   +   +---+   +   +   +---+---+   +---+   +---+---+---+   +---+---+   +
|           |   |   |           |   |   |   |       |           |   |       |           |                   |   |       |
+   +---+---+   +   +---+---+   +   +   +   +---+---+---+---+---+   +   +   +   +---+---+---+   +---+   +---+   +   +---+
|   |           |               |   |   |                           |   |   |   |   |       |       |   |       |       |
+   +   +---+---+---+---+   +---+   +   +---+---+---+---+---+---+---+   +   +   +   +   +   +---+---+   +   +   +---+   +
|   |   |       |           |       |                   |               |   |       |   |       |       |   |           |
+   +   +---+   +   +---+---+   +---+   +---+   +---+   +   +---+---+   +   +   +---+   +---+   +   +---+---+   +---+---+
|   |       |   |           |       |   |       |   |   |       |       |   |   |       |   |   |           |   |       |
+   +---+   +   +---+---+   +---+   +---+   +---+   +   +---+---+   +---+   +---+   +---+   +   +   +---+   +---+   +   +
|       |   |   |       |       |           |       |               |   |       |   |   |       |       |   |       |   |
+   +---+   +   +   +   +---+   +---+---+---+   +---+---+---+---+---+   +---+   +   +   +   +---+---+---+   +   +---+   +
|   |       |       |                           |               |           |       |   |   |           |       |       |
+---+   +---+---+---+---+   +---+---+---+---+---+   +---+   +---+   +   +---+---+---+   +   +   +---+   +---+---+   +   +
|       |       |       |   |               |       |   |           |               |       |   |   |               |   |
+   +   +   +   +   +   +---+   +---+---+   +   +---+   +---+---+---+---+---+---+   +   +---+   +   +---+---+---+---+   +
|   |   |   |   |   |           |           |   |       |       |               |   |       |   |               |       |
+   +---+   +   +   +---+---+---+   +---+---+   +   +   +   +   +---+---+---+   +   +---+   +   +   +---+   +---+   +---+
|           |                   |                   |       |                   |               |       |             T |
+---+---+---+---+---+---+---+---+---+---+---+---+---+---+---+---+---+---+---+---+---+---+---+---+---+---+---+---+---+---+
