+---+---+---+---+---+---+---+---+---+---+---+---+---+---+---+---+---+---+---+---+---+---+---+---+---+---+---+---+---+---+
| O     |           |                       |                       |   |               |               |               |
+---+   +   +---+   +   +---+---+---+---+   +   +---+---+---+---+   +   +   +---+---+   +   +   +---+   +---+---+   +   +
|   |   |       |       |           |       |   |           |       |   |   |       |   |   |   |   |   |       |   |   |
+   +   +   +   +---+---+   +---+---+   +---+   +   +---+   +   +---+   +   +   +   +   +   +   +   +   +   +   +   +   +
|   |   |   |       |                   |       |   |   |   |   |           |   |   |       |   |   |   |   |       |   |
+   +   +   +---+   +---+---+---+   +---+---+   +   +   +   +   +   +---+---+   +   +---+---+   +   +   +   +---+---+   +
|   |   |   |   |       |       |   |           |   |       |   |   |           |               |   |   |   |           |
+   +   +   +   +---+   +   +   +   +   +---+---+   +   +---+   +   +   +---+---+---+---+---+---+   +   +   +   +---+---+
|       |   |       |       |   |       |           |   |       |   |   |       |           |       |       |   |       |
+   +---+   +   +   +---+---+   +---+---+   +---+---+---+   +---+   +   +   +   +---+---+   +   +   +---+---+   +   +   +
|       |       |           |           |               |   |   |   |       |   |           |   |           |   |   |   |
+---+   +---+---+---+---+---+   +---+   +   +---+---+   +   +   +   +---+---+   +   +---+---+   +---+   +---+   +   +---+
|   |                       |       |   |   |           |   |       |           |   |           |   |   |       |       |
+   +---+---+---+---+---+   +---+---+   +---+   +---+   +   +---+---+   +---+---+   +   +---+---+   +   +   +---+   +   +
|   |                   |           |       |   |       |           |   |           |   |   |       |   |   |       |   |
+   +   +---+---+---+   +---+---+   +---+   +   +   +---+---+---+   +   +   +   +---+   +   +   +   +   +   +---+---+   +
|       |       |   |       |       |       |   |       |       |       |   |           |       |   |                   |
+   +---+   +   +   +   +---+   +---+   +---+   +---+   +   +   +---+---+   +---+---+---+   +---+   +---+---+---+---+   +
|           |       |           |   |       |       |       |   |       |   |       |           |           |       |   |
+---+---+---+---+   +---+---+---+   +   +   +   +   +---+---+   +   +   +   +   +   +   +---+---+---+---+   +   +   +   +
|               |   |       |           |   |   |           |   |   |       |   |   |   |       |           |   |   |   |
+   +---+   +---+   +   +   +   +---+---+   +   +---+---+   +---+   +---+---+   +   +---+   +   +   +   +---+   +   +---+
|       |           |   |               |   |       |   |                       |       |   |   |   |   |       |       |
+---+   +---+---+---+---+   +---+---+---+   +---+   +   +---+---+---+---+---+---+---+   +   +   +   +   +   +---+---+   +
|   |                   |       |           |   |   |           |                   |       |   |   |   |       |       |
+   +---+---+---+---+   +---+   +   +---+---+   +   +---+   +---+   +---+---+---+   +---+---+   +   +   +---+   +   +   +
|                   |   |       |   |       |       |       |       |           |       |           |       |   |   |   |
+   +---+   +---+---+   +   +---+   +   +   +---+   +   +   +   +---+   +   +---+---+   +---+---+---+   +---+   +   +---+
|   |       |           |       |       |       |       |   |           |   |       |   |           |   |       |       |
+   +---+---+   +---+---+---+   +---+---+---+   +---+---+---+   +---+---+   +   +   +   +   +---+   +---+   +---+---+   +
|           |   |           |   |   |       |       |           |       |   |   |   |       |       |       |       |   |
+   +---+   +   +   +   +   +   +   +   +   +   +   +   +---+---+   +   +---+   +   +---+   +   +---+   +---+   +---+   +
|       |       |   |   |   |       |   |   |   |           |       |       |   |       |   |           |           |   |
+---+   +---+---+---+   +---+---+   +   +   +---+---+---+   +   +---+---+   +   +---+   +---+---+---+   +---+---+   +   +
|   |           |       |           |   |   |       |       |   |       |       |   |   |           |       |       |   |
+   +---+---+   +   +---+   +---+---+   +   +   +   +---+---+   +   +   +---+---+   +   +   +---+   +---+   +   +   +   +
|           |   |   |       |       |   |       |   |           |   |       |       |       |       |   |   |   |   |   |
+   +---+   +   +   +   +---+   +   +   +---+---+   +   +---+   +   +---+   +---+   +---+---+   +---+   +   +   +---+   +
|   |       |   |           |   |       |       |   |   |       |   |       |               |   |       |       |       |
+   +   +---+   +---+---+   +   +---+---+---+   +   +   +   +---+   +   +---+   +---+---+---+   +---+   +---+   +   +---+
|   |       |           |   |               |       |   |   |       |   |       |               |           |   |       |
+---+---+   +---+---+   +   +---+---+---+   +---+   +   +   +   +---+   +   +---+   +---+---+---+   +---+---+   +---+   +
|       |       |       |       |       |       |   |   |   |   |       |       |       |   |           |       |       |
+   +   +   +   +   +---+---+---+   +   +---+   +   +   +---+   +   +---+---+   +---+   +   +   +---+   +   +---+   +   +
|   |       |   |   |               |           |   |           |   |           |       |   |   |   |       |       |   |
+   +---+---+   +   +   +---+---+---+---+---+---+   +   +---+---+   +   +   +---+   +---+   +   +   +---+---+   +---+   +
|   |           |       |               |           |       |   |   |   |       |   |       |   |       |       |       |
+   +---+---+---+---+---+   +   +---+   +   +---+---+---+   +   +   +   +---+   +   +---+   +   +---+   +   +---+   +---+
|               |       |   |       |   |       |       |   |   |   |   |   |           |               |   |   |   |   |
+   +---+---+   +   +   +   +---+   +---+---+   +   +   +   +   +   +   +   +---+---+   +---+---+---+---+   +   +   +   +
|       |       |   |   |       |   |       |   |   |   |   |   |   |       |       |                       |           |
+---+   +   +---+   +   +---+   +   +   +   +   +---+   +   +   +   +---+---+   +   +---+---+---+---+---+---+   +---+---+
|   |   |   |       |       |   |   |   |       |       |       |               |               |           |   |       |
+   +   +   +   +---+---+   +   +   +   +---+---+   +---+---+   +---+---+---+---+---+---+   +   +   +---+   +---+   +   +
|       |       |       |       |       |       |       |                   |           |   |           |           |   |
+   +---+---+---+   +   +---+---+---+---+   +---+   +   +   +---+---+---+---+   +---+   +---+---+---+---+---+   +---+   +
|   |           |   |                   |           |           |               |       |       |           |       |   |
+   +   +---+   +---+---+---+   +---+   +---+---+---+---+---+---+   +---+---+---+   +---+   +   +   +---+   +---+---+   +
|       |                       |                                   |                       |       |                 T |
+---+---+---+---+---+---+---+---+---+---+---+---+---+---+---+---+---+---+---+---+---+---+---+---+---+---+---+---+---+---+
