#############################################################
#O  #     #     #     #         #                     #     #
### ### # # ### # ### # ### ##### ##### # ########### # ### #
# #     # #   #   # # # # #   #   #   # #   #   # #   #   # #
# ####### # # ##### # # # ### # ### # # ### # # # # ##### # #
#         # #   #   # # #   #     # # #   #   # # #     # # #
# ######### ### # ### # ### ####### # ######### # ##### # # #
# #       #   # #     #   #   #     #           #       # # #
# ####### # ### ##### ### # # # ################# ######### #
#       #   #   #   # #   # # #         #       #   #     # #
####### # ### # # # ### ### # ####### # ##### # ### # ### # #
#     # # # # # # #   #     # #     # #     # # #   #   #   #
# # ### # # # ### ### ### ##### ### ####### # # # ##### ### #
# #     # # #     # # #   #     # #         # # # #   # # # #
# ####### # ####### # # ### ##### ########### # # # # # # # #
#     #   #     #   #     #     # #   #     # #   # #   # # #
##### # ##### # # # ##### ##### # # # # ### # ##### ##### # #
#   # #       # # # #   #     # # # #   #   # #     #     # #
# # # ######### # # # # ####### # # ##### # # ### ##### ### #
# # #     #   # # # # # #       #   #     # #     #     #   #
# ####### # # # # ### # # ######### # ##### ######### ### ###
#       # # #     #   #   #       # # # #   #         #   # #
# # ##### ####### # ####### ### # ### # # ### ### ##### ### #
# # #     #     # # #       #   #   # # #   # #   #   #     #
# # # ##### ### # # ### ##### ##### # # # ### # ### # ##### #
# # # #     #   # #   #     #     # # #   #   #     #   #   #
### # ##### # ####### ##### ##### # # ##### ######### ### ###
#   #       #     #   #   # #   # #   #     #       #   # # #
# # ############# # ### ### # # # ### # ####### ### ### # # #
# #   #       #   # # #     # # #   # # #       #   # # #   #
# ##### ### ### ### # # ##### # ### ### # ### ### ### # ### #
#     # # #   # #   # # #     #     #   #   #   #     #   # #
# ### # # ### # # ### # # ####### ### ##### ### ####### # # #
#   # #     # #   #     # #   #   #   #       #   #     # # #
### # ### ### ##### ##### # # # ### ############# # ##### # #
#   #   # #       #     # # #   # # #     #       # #     # #
# ### ### # ### ##### ### ##### # # # ### # # ##### # ##### #
#   #     # #   #     #   #   #   #   # #   # #     #   #   #
### ####### ##### ##### ### # ######### ##### # # ####### ###
# # # #     #     #   #   # #         #       # # #       # #
# # # # ### # ##### ##### # ######### # ####### ### ####### #
# #   # #   #     # #   # # #     # #   #     #     #       #
# ### # # ####### # # # # # ### # # ##### ### ####### ##### #
#     # # #     # # # #   #     # #   #     #         # #   #
# ##### # ##### # # # ########### # # # ####### ### ### # ###
# #     #       # # #             # # # # #   #   # #   #   #
# # ######### ### # ############### # # # # # ##### # # ### #
# # #   #     #   #         #       # #   # #   #   # #     #
# # ### # ##### ### ### ### # ##### # # ### ### # ##### #####
# #   # #     #   # #   # # #   #   # # #   # # #     # #   #
# ### # ##### ### ### ### # ##### ### ### ### # # ### ### # #
#   # # #   #   #     #   #       # #   # # #   #   # #   # #
# ### # # # ### ####### ########### ### # # # ####### # ### #
# #   #   #             #       #     #   # # #     #   #   #
### ######### ########### ### ### # ####### # # ### ##### # #
#   #   #   # #       #   # #     #       #   # # #       # #
# # # # # # ### ##### # ### ############# # ### # ######### #
# # # # # #     #     # #   #   #       # #   # #       #   #
# ### # # ####### ##### # # # # ####### # ### # # ### ### ###
#     #         #         #   #         #       #   #      T#
#############################################################
