#############################################################
#O  #     #           #           # #       #       #       #
### # ### # ######### # ######### # # ##### # # ### ##### # #
# # #   #   #     #   # #     #   # # #   # # # # # #   # # #
# # # # ##### ##### ### # ### # ### # # # # # # # # # # # # #
# # # #   #         #   # # # # #     # # #   # # # # #   # #
# # # ### ####### ##### # # # # # ##### # ##### # # # ##### #
# # # # #   #   # #     # #   # # #     #       # # # #     #
# # # # ### # # # # ##### # ### # # ############# # # # #####
#   # #   #   # #   #     # #   # # #   #     #   #   # #   #
# ### # # ##### ##### ####### ### # # # ##### # # ##### # # #
#   #   #     #     #       # # # #   # #     # #     # # # #
### ########### ### # ##### # # # ##### # ##### ### ### # ###
# #           #   # # #     # #   #     # #     # # #   #   #
# ########### ##### ### ### # ##### ##### # ##### # # ### # #
# #         #     #   # #   #     # #     # # #   # # #   # #
# # ####### ##### ### # # ####### # # # ### # # # # # ##### #
#   #   # #   #   #   # #   #   #   # #     #   # #         #
# ### # # # ### ### ### ### # # ##### ####### ### ######### #
#     #   #     # #   #   #   # #   # #   #     #     #   # #
######### ####### # # # # ##### # # # # # # ######### # # # #
#       # #   #     # # #     # # #   # # # #   #     # # # #
# ### ### # # # ##### # ##### ### ##### # ### # # # ### # ###
#   #     # #       # #   # #           #   # # # # #   #   #
### ######### ####### ### # ############### # # # # # ##### #
# #         #   #     # # #     #         #   # # # #   #   #
# ######### ### # ##### # ### ### ####### ##### # # ### # # #
#         # #   # #   #   #   #   #     #   #     #   # # # #
# ### ##### # ### # # ### # # # ### # ##### ####### ### # ###
# #   #     #   #   #   #   # #     # #   # #     # #   #   #
# ##### ####### ####### ####### ##### # # # # ### ### ##### #
#     # #     # # #   #   #     #   # # # #   #   #   #   # #
# ### # # # # # # # # # # # ##### # ### # ### # ### ### ### #
#   #   # # # #   # # # #     #   #   # #   # #     #     # #
### ####### ##### # # ####### # ##### # ### ####### ##### # #
# #     #   #     # # #   #   # #   #   # # #     #   #   # #
# ##### # ### ##### # # # ##### # # ##### # # ### ### # # # #
#     # # #   #   # #   # #     # #   #   #   #   # # # # # #
# ### # # # ### # # ##### # ### # ### ### ##### ### # # ### #
# #   # #     # #   #   # # #   # #   #       # #   #   #   #
# # ### ##### # ####### # # # ### # ### ####### ### ### # ###
# #   #     # #       #   # # #   # #   #       #     # #   #
##### ##### # ####### ### # # # ### # ### ####### ##### ### #
#   #   #   #   #   #   # # # # #   #   #   # #     #   #   #
# # # # # ####### # ### # # ### # ##### ### # # ### # ### # #
# #   # # #       #     # #     # #     #   # # # #   #   # #
# ##### # # ############# # ##### # # ### ### # # ##### ### #
# #     #   #       #     #   # # # #   # #   # #   #   #   #
# ########### # ### # ####### # # # ### # ### # ### # ### ###
#       #   # #   # #   #   # # # # # #     #       # # # # #
# ##### # # # ### ##### # # # # # # # ##### ######### # # # #
#   #   # # #   # #   # # # # # # #   #   #           #     #
### # ### # ### # # # # ### # # # ##### # ############# #####
# # # #   #   # # # #   #   #   #       #       #     # #   #
# # # # ##### # # # ##### ##### ############# # # ### ### # #
#   #   #   #   #   #   #   #         #     # #     #     # #
# ####### # ######### ### # # ######### ### ########### ### #
# #     # #         #     #     #       #   #   #     #   # #
# # ### ####### ### ############# ####### ### # # ### ##### #
#   #           #                 #           #   #        T#
#############################################################
