#############################################################
#O#               #               #       #       #         #
# # ####### ##### # ######### ### # ##### # ##### ### ##### #
# # #       # #   #   #       #   # #       #   #     #   # #
# # # ####### # ####### ####### ### ######### # ####### # # #
# # #   #     #         #       # #           #     #   # # #
# ##### # ### ########### ####### # ############### # ### # #
#       # #             #   #     # #     #       # # #   # #
######### # ############### # # ### ### # ##### # # # ##### #
#     #   # #             # # #     #   # #   # # # #     # #
### # ##### # ######### ### # ####### ### # # # # # # ### # #
#   #       #     # #   #   #       #   #   # # # # #   # # #
# ##### ######### # # # # ######### ### ##### ### # ### # # #
#   #   #   #     # # # # #   #   #     #   #     #   # # # #
### ##### # # ##### # ### # ### # ####### # ##### ### ### # #
#   #     # # #     #     #     # #       #     # #   #   # #
# # # ##### # ##### ####### ##### # ######### # # # ### ### #
# # # # #   # #   #   #   # #   #   #   #   # #   # #     # #
# ### # # ### # # # # ### # # # ####### # # # ##### ##### # #
#     # # #   # #   # #   #   # #       # # #   # # #   #   #
# ##### # # ### ##### # ####### # # ##### # ### # # # # ### #
# #     # # #     #     #     #   # #   # # #     #   #   # #
# # ### # # # ### ### ### ### ##### # # # # ### ##### ### # #
# # #   #   #   #   # #   # #       # #   #   # #   #   # # #
# # # ######### ### ### ### ######### ####### # # # ##### # #
#   # #     #     #     #   #   #     #     # # # # #   # # #
##### ### # # ####### ### # # # # ##### ### # ### # # # # # #
#   #   # # #   #   #     # # # #       #   #   # #   #   # #
# # ### # # # ### # ####### # # ######### ##### # ######### #
# # #   # #   #   # #     # # #           #     # #       # #
# ### ######### ### # ### ### ############# ##### ##### ### #
# #   #         #   #   #   # #   #     #   #         #   # #
# # ##### ####### ##### ### # # # # # # # ### ####### # # # #
# #       #     #       #   #   # # # # # #   #       # #   #
# ########### # ######### ####### # # # # ### # ########### #
#           # #         # #     # # # # #   # # #     #   # #
# ##### ### # ########### # ### # # # ##### # # # ### # # # #
#   #   #     #         # # # # # # #     # # # #   #   # # #
### # ######### ####### # # # # # ##### # # # # ### ##### ###
# # #           #     # # # # # #   #   # # # #   # #   #   #
# # ############# ##### # # # # # # # ### # # ### # # # ### #
#   #         #     #   #   #   # # #   # # #   # # # #     #
# ### ######### ### # ####### ### # # # ### ### # # # #######
#   # #         #   #     #   # # # # #     #   #   #       #
### # # ######### ####### # ### # # ##### ####### ######### #
# # #   #     # #       #   #   # #     #       # #       # #
# # # ### ### # ### ### ####### # ##### ####### # # ##### # #
#   #   # #       # #     #   #   #   # #   #   #   #     # #
# ##### # ####### # ##### # # ##### # # ### # ####### ##### #
#   # #   #   #   #   #     #     # #   #   #     # #   # # #
### # ### # # ##### # ########### # ##### ####### # ### # # #
# # # #   # #     # #     #         # #           #   #   # #
# # # # ### ##### # ##### ### ####### # ########### ### ### #
# # #     #     # #     #   #   #   # # #       #       #   #
# # # ######### # ##### ### ##### # # # # ##### ### ##### # #
#   # #     #   # #       # #     # # # #     #   #   #   # #
# ### # ### # ### ######### # ##### # # ##### ### ##### ### #
#   # # #   # # #   #     #   #     #   #   #   #   #   #   #
### ### # ### # ### # ### ##### ##### ### # ### ### # ### ###
#       #     #       #         #         #     #     #    T#
#############################################################
