+---+---+---+---+---+---+---+---+---+---+---+---+---+---+---+---+---+---+---+---+---+---+---+---+---+---+---+---+---+---+
| O |                               |                               |               |               |                   |
+   +   +---+---+---+   +---+---+   +   +---+---+---+---+   +---+   +   +---+---+   +   +---+---+   +---+   +---+---+   +
|   |   |               |   |       |       |               |       |   |               |       |           |       |   |
+   +   +   +---+---+---+   +   +---+---+---+   +---+---+---+   +---+   +---+---+---+---+   +   +---+---+---+   +   +   +
|   |   |       |           |                   |               |   |                       |           |       |   |   |
+   +---+---+   +   +---+   +---+---+---+---+---+   +---+---+---+   +   +---+---+---+---+---+---+---+   +   +---+   +   +
|               |   |                           |       |           |   |           |               |   |   |       |   |
+---+---+---+---+   +   +---+---+---+---+---+---+---+   +   +   +---+   +---+   +   +---+---+   +   +   +   +---+---+   +
|           |       |   |                           |   |   |           |       |   |       |   |   |   |           |   |
+---+   +   +---+---+   +   +---+---+---+---+   +---+   +   +---+---+---+   +---+   +   +   +   +   +   +   +---+   +   +
|       |               |           |   |       |       |               |       |       |   |   |   |   |       |   |   |
+   +---+---+   +---+---+---+---+   +   +   +   +   +---+---+---+---+   +---+   +---+---+   +---+   +   +---+   +   +   +
|       |       |       |           |   |   |   |   |       |       |           |       |           |       |   |   |   |
+---+   +---+---+   +   +   +---+---+   +   +---+   +   +---+   +   +---+---+---+   +   +---+---+   +---+   +---+   +   +
|       |           |   |   |           |           |           |   |               |           |   |       |       |   |
+   +   +   +---+---+   +   +---+---+   +---+---+---+   +---+---+   +   +---+---+---+---+   +   +   +   +---+   +---+   +
|   |   |   |   |       |   |       |       |       |   |       |       |       |       |   |       |   |           |   |
+   +---+   +   +   +---+   +   +   +   +   +---+   +   +   +   +---+---+---+   +   +   +   +---+---+   +---+---+   +   +
|           |   |   |       |   |       |   |       |       |   |               |   |   |       |   |   |       |       |
+   +---+---+   +   +   +---+   +---+---+   +   +---+---+---+   +   +   +---+---+   +   +---+   +   +   +   +   +---+   +
|   |           |   |   |           |           |           |       |   |       |   |   |           |       |       |   |
+   +   +---+   +   +   +   +---+   +---+   +---+   +---+   +---+---+   +   +   +   +   +---+   +---+---+   +---+   +   +
|   |   |       |       |       |       |   |       |   |               |   |       |       |   |       |       |   |   |
+   +   +   +---+---+---+---+   +---+   +---+   +---+   +---+---+---+---+   +---+---+---+   +   +   +   +---+---+   +   +
|       |   |           |           |           |       |       |           |           |   |   |   |   |       |   |   |
+---+---+   +---+   +   +   +---+---+---+   +---+   +   +   +   +   +---+---+   +---+   +   +---+   +   +   +   +   +   +
|       |       |   |   |       |       |           |   |   |   |               |       |       |   |       |       |   |
+   +   +---+   +   +   +   +---+   +   +---+---+---+   +   +   +---+---+---+---+   +---+---+   +   +---+---+---+---+   +
|   |   |       |   |       |       |   |           |   |   |                       |           |   |               |   |
+   +---+   +---+---+---+---+   +---+   +   +---+   +---+   +---+---+---+---+---+---+   +---+---+   +---+---+   +---+   +
|   |       |                   |       |       |       |   |       |           |       |                   |       |   |
+   +   +---+---+   +---+---+---+   +---+---+   +---+   +   +   +   +   +   +   +   +---+   +---+---+---+   +   +   +   +
|   |               |           |               |       |       |   |   |   |   |   |       |               |   |       |
+   +---+---+---+---+---+   +   +---+---+---+---+   +---+---+---+   +   +   +   +   +---+   +   +---+---+---+---+---+   +
|                       |   |                   |   |           |   |   |   |   |       |   |   |           |       |   |
+   +---+---+   +---+   +   +---+---+---+---+---+   +   +---+   +   +   +   +---+---+   +   +   +   +---+   +   +   +   +
|       |       |           |                   |   |   |   |   |   |   |           |   |   |   |       |       |   |   |
+---+   +   +---+---+---+---+   +---+---+---+   +   +   +   +   +   +---+---+   +   +   +   +   +---+   +---+---+   +---+
|   |   |                       |           |   |   |   |   |   |       |       |   |   |   |       |   |       |       |
+   +   +---+---+---+---+---+---+   +---+---+   +   +   +   +   +   +   +   +---+   +   +   +---+   +   +   +   +---+   +
|       |                   |           |       |       |       |   |   |       |   |   |       |   |   |   |           |
+   +---+   +---+---+---+---+   +---+   +   +---+---+---+   +---+   +   +   +   +---+   +---+   +   +   +   +---+---+---+
|       |   |                   |       |           |       |   |   |   |   |           |       |       |               |
+---+   +   +   +---+---+---+---+   +---+---+---+   +   +---+   +   +   +---+---+   +---+---+---+   +---+---+---+---+   +
|   |   |       |           |   |               |       |       |   |           |               |   |               |   |
+   +   +   +---+   +---+   +   +---+   +---+   +---+---+---+   +   +---+---+   +---+---+---+   +   +   +---+---+   +   +
|       |       |   |               |   |           |       |       |       |   |       |       |       |           |   |
+   +---+---+   +   +---+---+---+   +   +---+---+   +   +   +---+---+   +   +   +---+   +   +---+---+---+   +---+---+   +
|       |   |       |       |       |       |           |           |   |       |       |           |   |       |   |   |
+---+   +   +---+   +   +   +---+---+   +   +---+---+---+---+---+   +   +---+---+   +---+---+---+   +   +---+   +   +   +
|   |   |   |       |   |           |   |           |                   |   |                       |       |       |   |
+   +   +   +   +---+   +---+---+   +   +---+---+   +---+   +---+---+---+   +   +---+---+---+---+---+   +---+   +---+   +
|   |   |           |           |   |           |       |       |       |   |   |               |               |       |
+   +   +   +---+---+---+---+   +   +---+---+   +---+   +---+---+   +   +   +   +   +---+---+   +---+   +---+---+   +   +
|       |   |           |       |   |               |   |           |   |   |   |           |       |       |       |   |
+   +---+   +   +---+   +   +---+   +---+---+---+---+   +   +---+---+   +   +   +---+---+   +---+   +---+---+   +---+   +
|       |   |   |       |   |   |       |           |       |           |       |       |       |       |       |       |
+---+   +---+   +   +---+   +   +---+   +   +---+   +---+---+   +---+---+   +---+   +   +---+   +---+   +   +---+   +---+
|               |           |               |                   |                   |           |           |         T |
+---+---+---+---+---+---+---+---+---+---+---+---+---+---+---+---+---+---+---+---+---+---+---+---+---+---+---+---+---+---+
