+-+-+-+-+-+-+
|S  | |     |
+-+ + + + + +
| | |   | | |
+ + + +-+ + +
| | | | | | |
+ + + + + +-+
|   |   |   |
+ +-+-+-+-+ +
| |     |   |
+ + +-+ + + +
|   |     |E|
+-+-+-+-+-+-+
