#############
#S  # #     #
### # # # # #
# # #   # # #
# # # ### # #
# # # # # # #
# # # # # ###
#   #   #   #
# ######### #
# #     #   #
# # ### # # #
#   #     #E#
#############
