#####################
#O  # #   #   #     #
### # # # # # # # ###
# # #   #   #   #   #
# # # ##### ####### #
#   # #   #   #   # #
# ### # # ##### # # #
# #   # #     # #   #
# ##### ##### # ### #
# #     #     # # # #
# # ##### ##### # # #
# # #     #   # # # #
# # # ##### # # # # #
#   # #   # # # #   #
##### # # # # # # ###
# #   # #   #   # # #
# # ### ######### # #
# #     #       # # #
# ####### ##### # # #
#             #    T#
#####################
