+---+---+---+---+---+---+---+---+---+---+
| O |                                   |
+   +---+   +   +---+---+---+---+---+---+
|       |   |                           |
+---+   +---+---+---+   +---+---+---+   +
|   |               |   |           |   |
+   +---+---+---+   +   +   +---+   +   +
|           |       |   |       |   |   |
+---+---+   +   +---+   +---+   +---+   +
|           |       |           |       |
+   +---+---+---+   +---+---+---+   +   +
|   |           |               |   |   |
+   +   +   +---+---+---+---+   +   +   +
|       |                   |   |   |   |
+   +---+---+---+---+---+   +   +   +---+
|       |               |   |   |       |
+---+   +   +---+---+   +   +   +---+   +
|   |   |   |       |   |       |       |
+   +   +   +   +---+   +---+---+   +   +
|           |                       | T |
+---+---+---+---+---+---+---+---+---+---+
