#####################
#O#                 #
# ### # #############
#   # #             #
### ####### ####### #
# #       # #     # #
# ####### # # ### # #
#     #   # #   # # #
##### # ### ### ### #
#     #   #     #   #
# ####### ####### # #
# #     #       # # #
# # # ######### # # #
#   #         # # # #
# ########### # # ###
#   #       # # #   #
### # ##### # # ### #
# # # #   # #   #   #
# # # # ### ##### # #
#     #           #T#
#####################
