#############
#S#     #   #
# # ### ### #
# # # #   # #
# # # ### # #
#   #   #   #
##### ##### #
#       #   #
# ##### # ###
# #   # # # #
# # # # # # #
#   # #    E#
#############
