+-+-+-+-+-+-+-+-+-+-+-+-+-+-+-+
|S  |     |   |               |
+-+ + + + + + +-+ + +-+-+-+-+ +
| | | | |   |   | |   |     | |
+ + +-+ +-+-+-+ + +-+ + +-+ + +
| |     |       |   | |   |   |
+ +-+-+-+ +-+-+-+-+-+ +-+ +-+-+
|       | |       |   | | |   |
+-+-+ + + + + +-+ + +-+ + +-+ +
|     | | | | | |   |   |   | |
+ +-+-+ + +-+ + +-+-+ + +-+ + +
|   |   |     |       |   | | |
+-+ + +-+-+-+-+ + +-+-+-+ + + +
|   |   |     | |   | |   | | |
+ +-+-+ +-+ + +-+-+ + + +-+ + +
|     |     |     | |     | | |
+ +-+ +-+-+ +-+-+ + + +-+-+ + +
| | | |     |   |   | |   | | |
+ + + + +-+-+ + +-+ +-+ + + + +
|   | |   |   | | | |   |   | |
+-+ + +-+ + +-+ + + + +-+-+-+ +
|   |   | | |   |   |       | |
+ +-+-+ + + + +-+-+-+-+-+-+ + +
| |   | | | |       |     | | |
+ +-+ + +-+ +-+-+-+ + +-+ + + +
|   | |   |       |     | |   |
+-+ + +-+ +-+-+-+ +-+-+-+ +-+ +
|   |   |       | | |       | |
+ +-+-+ +-+-+-+ + + + +-+-+-+ +
|             |     |        E|
+-+-+-+-+-+-+-+-+-+-+-+-+-+-+-+
