#############
#S#         #
# ### ##### #
#   #   #   #
### ##### # #
# #     # # #
# ##### # # #
#     # # # #
# ### # # ###
# # #   #   #
# # ####### #
#          E#
#############
