#######
#S    #
##### #
#     #
# #####
#    E#
#######
