###############################
#S#           #               #
# ##### ##### # ##### ####### #
#       #     # #   #   #   # #
######### ##### ### ### # # # #
#       #   # #   # #   # # # #
# # ####### # ### # # ##### # #
# #     #   #   # # #     #   #
####### # ##### # # ##### #####
#       # #   # # #   # # #   #
# ##### # # # # # # # # # # # #
# #     # # #   #   #   #   # #
# ####### # # ######### ##### #
#         # # #     #       # #
# ######### ### ### # ##### # #
#     #   #       #   #   # # #
##### # # # ########### # ### #
#   # # # #   #         #     #
### # # ##### # ############# #
#   # #       # #   #     #   #
# ### ##### ### # # # # ### ###
#   #     #   # # # # #   #   #
# # ##### ### # ### # ### ### #
# #     # #   #   #     #   # #
# # ### # # ##### ####### ### #
# #   # # #   # #       #     #
# ### ### ### # ####### # #####
#   #   #   #   #     # # #   #
### ### ### ##### ### # # ### #
#     #           #     #    E#
###############################
