###############################
#S  #   #         #         # #
### # # ####### # # ####### # #
# #   #     #   # # #         #
# ######### # ### # ###########
#       #   # # # #           #
### ### # ### # # ########### #
#   #   # #   #   #           #
# ### ### # # # ### ######### #
# #     # # # #   #   #       #
# ####### ### ### ### # #######
#   #   # #   #       #     # #
### # # # # ### ########### # #
#   # #   #   # #       #   # #
# ### ####### ### ##### # ### #
# #   #       #   #   # # #   #
# # ### ##### # ### # # # ### #
#   #     # # # # # #   #     #
# ####### # # # # # ######### #
#       # #   # # #     #     #
####### # ##### # ##### ##### #
# #     #   #         #     # #
# # ##### # # ############# # #
# #     # #     #           # #
# ##### ### ##### ########### #
#     #   #   #   #   #     # #
##### ### ### # ### # # ### # #
#       # #   # # # #   # #   #
# ####### ##### # # ##### #####
#               #            E#
###############################
