+---+---+---+---+---+---+---+---+---+---+---+---+---+---+---+---+---+---+---+---+---+---+---+---+---+---+
| O |       |           |                           |               |       |               |           |
+   +   +---+   +   +   +---+   +---+---+---+   +   +   +   +---+   +   +   +   +---+---+   +   +---+   +
|   |           |   |       |       |       |   |       |   |       |   |               |           |   |
+   +---+   +---+   +---+   +---+---+   +   +   +---+---+   +   +---+---+---+---+   +---+---+---+---+   +
|       |   |       |   |   |           |   |   |       |   |                   |   |                   |
+---+   +   +   +---+   +   +   +---+---+   +   +   +---+   +---+---+---+---+   +   +   +---+---+---+---+
|   |   |   |   |           |   |           |       |       |       |           |   |                   |
+   +   +---+   +---+   +---+   +---+---+   +---+   +   +---+   +---+   +---+---+---+   +---+---+---+   +
|   |       |       |           |       |   |       |   |               |           |   |   |           |
+   +---+   +---+   +---+---+---+   +   +   +   +---+   +   +---+---+---+   +---+   +   +   +   +---+   +
|       |       |                   |   |   |       |   |       |       |       |   |       |       |   |
+   +   +---+   +   +---+---+---+---+   +   +---+---+   +---+   +   +---+   +   +   +---+   +---+   +   +
|   |           |           |   |       |       |       |       |           |   |   |       |       |   |
+   +---+---+---+---+---+   +   +   +---+---+   +   +---+   +---+---+---+   +   +   +---+---+   +---+   +
|   |                           |       |   |   |       |               |   |   |               |   |   |
+   +---+---+---+---+---+---+---+   +   +   +   +---+   +---+---+---+   +---+   +---+---+---+---+   +   +
|       |           |           |   |   |   |           |           |           |                   |   |
+---+   +   +---+   +   +---+   +---+   +   +---+---+---+   +---+   +---+---+---+---+---+---+   +   +   +
|       |   |   |       |               |   |           |   |       |                       |   |   |   |
+   +---+   +   +   +---+---+---+---+---+   +   +   +   +   +---+---+   +   +---+---+---+   +   +---+   +
|   |       |       |           |   |       |   |   |   |   |           |   |       |       |       |   |
+   +   +---+   +---+   +---+   +   +   +   +   +   +   +   +   +---+---+   +   +   +   +---+---+   +   +
|   |       |   |       |       |       |   |   |   |       |   |       |       |   |               |   |
+   +---+   +   +   +---+   +---+   +---+   +   +   +---+---+   +   +---+---+---+   +---+   +---+---+   +
|       |   |   |   |       |   |   |   |   |   |       |           |               |   |   |       |   |
+---+   +   +---+   +   +---+   +   +   +   +   +---+   +   +---+---+   +---+---+---+   +   +   +   +   +
|       |           |       |           |           |           |       |           |       |   |   |   |
+   +---+---+---+---+---+   +---+---+---+---+---+   +---+---+---+   +---+   +---+   +   +---+   +   +   +
|                       |       |               |   |           |   |           |   |   |       |       |
+---+---+---+---+---+   +---+   +   +---+---+   +---+   +---+   +   +---+---+---+   +   +   +---+---+---+
|       |           |       |               |               |   |   |           |       |       |       |
+   +---+   +   +---+---+   +---+---+---+---+---+---+---+   +   +   +   +---+   +---+---+---+   +   +   +
|       |   |   |       |       |                       |   |   |           |               |   |   |   |
+---+   +   +   +   +   +---+   +   +---+   +---+---+   +---+   +---+---+---+---+---+   +   +   +---+   +
|       |   |       |   |       |       |   |       |           |                   |   |               |
+   +---+   +---+---+   +   +---+   +   +---+   +   +---+---+---+   +---+---+---+   +   +---+---+---+---+
|   |           |       |   |       |           |                       |           |           |       |
+   +   +---+---+   +   +   +---+---+---+---+---+---+---+   +---+---+---+   +   +---+---+---+   +   +   +
|           |       |   |   |                           |       |   |       |   |           |   |   |   |
+   +---+---+   +---+   +   +   +---+---+---+---+---+   +---+   +   +   +---+---+   +---+   +---+   +   +
|   |           |       |   |   |           |       |       |       |           |   |   |   |       |   |
+   +   +---+---+   +---+   +   +   +---+   +   +   +---+   +---+   +---+---+   +   +   +   +   +---+   +
|   |           |   |       |       |   |       |       |   |       |       |           |       |       |
+   +---+---+   +   +   +---+   +---+   +---+---+---+   +   +---+---+   +   +---+---+   +---+---+   +   +
|       |       |   |       |               |       |   |           |   |           |           |   |   |
+---+   +   +---+---+---+   +---+---+---+   +   +---+   +---+---+   +   +---+---+   +---+---+   +   +---+
|   |   |               |               |       |       |       |   |       |       |       |   |       |
+   +   +---+---+---+   +---+---+---+   +   +---+   +---+---+   +   +---+   +   +---+   +   +   +---+   +
|       |   |           |           |   |   |       |           |   |       |           |   |   |       |
+   +---+   +   +---+---+   +---+   +   +---+   +---+   +   +---+   +   +---+---+---+---+   +---+   +   +
|           |                   |               |       |               |                           | T |
+---+---+---+---+---+---+---+---+---+---+---+---+---+---+---+---+---+---+---+---+---+---+---+---+---+---+
