+---+---+---+---+---+---+---+---+---+---+---+---+---+---+---+---+---+---+---+---+---+---+---+---+---+---+
| O |                           |                   |               |       |                   |       |
+   +   +---+---+---+---+---+   +---+---+   +   +   +---+   +---+   +   +   +---+   +   +---+---+   +   +
|   |   |                   |           |   |   |       |   |   |       |       |   |       |       |   |
+   +   +---+---+   +---+---+---+---+   +---+   +---+   +   +   +---+---+---+   +---+---+   +   +---+   +
|   |           |                   |           |   |       |           |       |           |   |       |
+   +   +---+   +   +---+---+---+   +---+---+---+   +---+---+   +---+   +   +---+   +---+---+   +   +   +
|   |   |       |           |               |               |   |   |       |       |           |   |   |
+   +---+   +---+---+---+---+   +---+---+---+   +---+   +   +   +   +---+---+   +---+   +---+---+   +   +
|   |       |               |       |               |   |   |   |                           |       |   |
+   +   +---+   +---+---+   +---+   +   +---+---+---+   +---+   +---+---+---+---+---+---+---+   +---+   +
|       |           |           |   |       |   |       |       |                               |   |   |
+---+---+   +---+   +---+---+   +   +---+   +   +   +   +   +---+   +---+---+---+---+---+---+---+   +   +
|       |   |   |       |               |       |   |   |   |       |       |                       |   |
+   +   +   +   +---+   +---+---+---+---+---+   +   +   +   +   +---+   +---+   +   +---+---+---+---+   +
|   |       |       |       |               |   |   |   |       |   |           |           |           |
+   +---+---+---+   +---+   +   +---+---+   +   +   +---+---+---+   +   +---+---+---+---+   +   +---+---+
|               |       |       |       |       |       |               |               |   |   |       |
+---+---+---+   +   +   +---+---+---+   +---+---+---+   +   +---+---+---+---+   +---+   +   +   +---+   +
|   |           |   |                       |           |   |           |       |       |       |       |
+   +   +---+---+   +---+---+---+---+---+---+   +---+   +   +   +---+   +   +---+   +---+---+---+   +---+
|   |   |                       |           |       |   |   |       |       |       |                   |
+   +   +---+---+---+---+---+   +   +---+   +---+   +---+   +---+   +---+---+   +---+---+---+   +---+   +
|   |               |       |   |   |           |       |           |       |       |       |       |   |
+   +---+---+---+   +   +   +   +   +   +---+   +---+   +---+---+---+   +---+---+   +   +   +---+   +   +
|       |       |   |   |   |       |       |   |                   |           |   |   |       |   |   |
+   +---+   +   +   +   +   +---+---+---+   +   +   +---+---+---+   +---+---+   +   +   +---+   +---+   +
|           |       |   |   |           |   |   |   |           |               |       |   |   |       |
+   +---+---+---+---+   +   +   +---+   +   +---+   +   +---+   +---+---+---+   +---+---+   +   +   +---+
|   |               |   |       |   |   |       |   |       |                           |       |       |
+   +   +---+---+   +   +---+---+   +   +   +   +   +---+---+---+---+---+---+---+---+   +   +---+---+   +
|       |       |   |   |           |   |   |   |                           |   |       |   |           |
+---+---+   +---+   +   +---+   +   +   +---+   +---+---+---+---+---+---+   +   +   +---+   +---+   +   +
|       |           |       |   |               |               |       |   |       |       |       |   |
+   +   +   +---+---+   +   +---+---+---+---+   +   +---+---+   +   +   +   +---+---+   +---+   +---+   +
|   |   |           |   |                   |   |   |       |   |   |   |           |       |   |   |   |
+   +   +---+---+   +   +---+---+---+---+   +   +   +   +---+   +   +   +---+---+   +---+   +   +   +   +
|   |           |   |       |           |   |       |           |   |       |           |       |   |   |
+   +---+   +---+   +---+   +---+   +---+   +---+---+---+   +---+---+---+   +   +---+---+---+---+   +   +
|       |   |       |       |       |       |           |               |   |                       |   |
+   +---+   +   +---+---+   +   +   +   +---+   +---+   +---+---+---+   +   +---+---+---+---+---+   +   +
|   |       |           |   |   |   |       |   |       |   |       |   |       |   |               |   |
+   +   +---+---+---+   +   +   +   +---+   +   +   +---+   +   +   +   +   +   +   +   +---+   +---+   +
|   |   |           |   |       |       |       |   |       |   |       |   |       |   |       |       |
+   +   +   +   +---+   +---+---+---+---+---+---+   +---+   +   +---+---+   +---+   +   +---+---+   +---+
|   |       |       |           |               |   |       |   |       |       |   |           |       |
+   +---+---+---+   +---+---+   +   +---+---+   +   +   +   +   +   +   +---+   +   +---+---+   +---+   +
|   |       |       |       |       |       |       |   |   |       |           |   |   |       |       |
+   +   +   +   +---+   +   +---+---+   +   +---+---+   +---+---+---+---+---+---+   +   +   +---+   +---+
|   |   |   |       |   |       |       |           |                           |       |       |       |
+   +---+   +---+   +   +   +---+   +   +---+---+---+   +---+   +---+---+---+---+---+   +---+   +---+   +
|               |       |           |                       |                               |         T |
+---+---+---+---+---+---+---+---+---+---+---+---+---+---+---+---+---+---+---+---+---+---+---+---+---+---+
