#####################################################
#O#             #         #       #   #         #   #
# # ########### ##### # # ### ### # # ### # ##### # #
# # #         #     # # #   # # #   #   # #   #   # #
# # ##### ######### ### ### # # ####### ##### # ### #
# #     #         #     # #   #     #   #     # #   #
# # ### # ####### ####### ##### ### # ### ##### # # #
# # #   #     #       #       # # #   #   #     # # #
# ### ######### ####### ### # # # ##### ### ##### # #
# #   #       #   #       # # # #             #   # #
# # ### ##### ### # ####### ### ############### ### #
#   #     #     # #   # #   #   #               # # #
##### ### ##### # ### # # # # ### ############### # #
#   # # #   #       #   # # # #   #   #           # #
# # # # ### ########### # # # # ### ### # ######### #
# #   #   #   #       # # # #   # #     #     #     #
# ####### ### # ##### # # ####### # ######### # #####
#       #   #   #   #   #   #       #       # # #   #
####### # # ####### ####### # ######### ### # # ### #
# #     # #           #     # #     #   #   #   #   #
# # ##### ############# ### # # ### # ### ####### ###
# # #           #     #   # # #   #   #   #         #
# # ########### # ### ### ### ### ##### ####### ### #
# #       #   # # #     #   #     #   #   #   #   # #
# ####### # # # # # ### ### ####### ##### # # ### # #
#   #   # # # #   #   # #         #     # # #   # # #
# ### # # # # ####### # # ####### ##### # # ### ### #
#     #   # # #     # # # #     #       #   # # #   #
# ######### # # ### # ### # ### ####### ##### # # ###
# #       # #   # # #   # #   #             #   #   #
# # ##### # ##### # # # # ################# # ##### #
#   #   # # #     # # # #             # #   # #     #
##### ### # ### # # ### ############# # # ### ### # #
#   #     #   # #       #       #   # #   #   #   # #
# # # ##### # ######### # ##### # # # ##### ### ### #
# # #     # #         # # #   # # # #     #   # # # #
# # ##### # ######### # # # ### # # ##### ### # # # #
# #     # #   #     # #   #     # #   #     #   # # #
# ### ### ### ### ### ####### ####### # ######### # #
#   # #   #   #   #   #     #       # #           # #
# ### # ##### # # # ### ### ####### # ########### # #
# #   #     # # # #   # #   # #   # #   # #       # #
# # ####### # # # ### # # ### # # # # # # # ### ### #
# # #     # #   #   #   # #   # #   # #   # #   #   #
# # # # ### ############# ### # ##### ### # ##### ###
# #   #   #     #       # #   # #   #   # #     #   #
# ####### ##### # ##### # # # # # # ### # ##### ### #
# #   #   #   #   #   #   # # #   #     # # #   #   #
# # # # ### # ##### # ##### ############# # # ### ###
# # # #   # #   #   #     #             #   #   #   #
# ### ### # # ### # ####### ### ########### ### ### #
#       #   #     #           #               #    T#
#####################################################
