#####################################################
#O  #         #                   #     #           #
### # ####### # ######### ####### ### # ########### #
# #   #     # #   #     #     #   #   #       #     #
# ######### # ### ### # ##### # ### ######### # ### #
#   #       #   #   # #     # #     # #     #   # # #
# # # # ### ### ### ### ##### ####### # ### ##### # #
# # # #   #   #   #     #     #   #       #       # #
# ### ### ### ### ####### ##### # ####### ### ##### #
# #     # #     # #       #     # #     # #   #   # #
# # ##### ####### # ##### # ##### # ### # # ### # # #
# # #   #     #   #   #   #   # # #   # # #     #   #
# # # # ### # # ##### ####### # # ### # ##### #######
#   # #   # # #     #         # #     #     # #     #
# ### ### # # ##### # ######### ########### # ##### #
# #   #   # #   # # #   #       #           #   #   #
### ### ##### # # # ### # ####### ############# # # #
#   #         # # # # # # #     #   # #       # # # #
# ############# # # # # # # ### ### # # # ### # # ###
#     #         # # # # # #   #     # # #   # # #   #
# ### # ####### # # # # # ### ####### # ### ### ### #
# #   # #     #   # #   #   # #   # #   # #   # #   #
# # ### # ### ##### # ##### # # # # # ### ### # # ###
# # #   #   #       #       #   # # #       #   #   #
# # # ##### ############### ##### # ####### ##### # #
# # # #     # #       #     #   # # #     #     # # #
### # # ##### # ### ### ##### # # # # # ####### ### #
#   # # # #   #   #         # # # # # #       #   # #
# ### # # # # ### ######### ### # # # ### ### ### # #
# #   # #   #       #   #       # # #   #   #   # # #
# ##### ##### ####### # ####### # # ### ### ##### # #
# #   #     # #   #   #     # # # #   # # # #   #   #
# # # ##### ### # # ####### # # # # # # # # # # ### #
#   #     #     #   # #   # #   # # # # # #   #   # #
# ####### ########### # # # ### # ### # # ####### # #
# #     #     #       # # #   # # #   #         # # #
# # ### # ##### ##### # # ### ### # ######### ### # #
#   #   #         #   # #   # #   #         # #   # #
##### ############# ### ### # # ##### ### ### # ### #
#   # # #     #     #   # #   # #   # # #   # #     #
# ### # # ### # ##### ### ##### # # # # ### # #######
# #   # #   # # #   #     #     # # #   #   # #     #
# # ### # ### # # # ##### # ##### # ##### # # ### # #
# # #     #   # # #   #   #   #   #       # #   # # #
# # ####### ### # # ### ##### ### ### ######### ### #
# #       #   #   #   # #   #   #   # #   #   #   # #
# ####### # # ####### # # # ### # # ### # # # ### # #
#     #   # #     #   #   #     # #   # #   #   # # #
# ##### ####### # # ############# ### # ####### # # #
#       #       # #         #   # # #   #     # #   #
# ####### ####### ### ####### # # # ##### ### # ### #
#         #         #         #           #   #    T#
#####################################################
