#####################################################
#O#   #     #             #       #   #       #     #
# # ### # # ### ####### # # # ### # # # ##### # ### #
# #     # #   #   #   # #   # #   # #       #     # #
# ### ### ### ##### # # ##### # ######### ######### #
#   # #   # # #     # # #   # #         # #         #
### # # ### # # ##### # # ### ######### # # #########
# # # # #     # #     #   #   #   #     # #         #
# # ### ### ### ##### ### # ### ### ####### ####### #
# #   #   #     #   # #   # #       #     # # #     #
# ### ### ####### # # # ### # ####### ### # # # ### #
#   #   #         # # #   # #   #   #   # #   #   # #
# # ### # ######### # ##### ### # ### # # ### ### # #
# #     #     # #   #   #   #   #     # # #   #   # #
# ########### # # ##### # ### ####### # # ##### ### #
# #             #   # # #   #       # # #       # # #
# ############### # # # ### ####### ### ######### # #
#   #     #     # # # #     #     #     #         # #
### # ### # ### ### # ####### ### ############# # # #
#   # # #   #       # #     # #   #           # # # #
# ### # # ########### # # # # ##### # ####### # ### #
# #   #   #     # #   # # # # #     # #   #   #   # #
# # ### ### ### # # # # # # # # ##### # # # ##### # #
# #   # #   #   #   # # # #   # #   #   # #       # #
# ### # # ### ### ### # # ##### # ####### ### ##### #
#   # # # #   # # # # # #   #     #       # # #   # #
### # ### # ### # # # # ### # ##### ####### # # # # #
#   #     #   #     #     #     #   #     #   # # # #
# ########### ########### ####### ### ### # ### # # #
#           #   #       # #     # #     # # #   #   #
########### ### # ##### ### ### # ####### # # #######
#   #     #   #       #       # # #     #   #   #   #
# ### # ##### ############### # # # ### ####### # # #
#   # # #   #   #           # # #     #       # # # #
### # # # # ### # ### ##### ### ########### # # ### #
#   # #   # #   #   # #   #     #         # #       #
# ### ##### # ### # ### # ####### ####### # #########
# #     #   # #   #     #           #     #     #   #
# # ##### # # ############### ####### # ####### # # #
#     #   # # #             #   # #   # #     # # # #
# ##### ### # # ########### ### # # ##### ### ### # #
# #     #   # # #     #   #   #   #     # # # #   # #
# # ##### ### # # ### # # ### ### ##### # # # # ### #
# #     # #   #   # #   #   # #   #   #     #   #   #
# ##### # # ### ### ####### # ##### # ##### ##### # #
#   #   # #   #       #   # #     # #     #     # # #
### # ####### ####### # ### ##### # ##### ##### # ###
# # #       #       #   #   #   # #   #   #   # #   #
# # ####### ####### # ### ##### # ### # ### # # ### #
#   # #     #     # # #   #     # #   #     # # #   #
# ### # ##### ### # ### ### # ### # ######### ### # #
#     #         #       #   #       #             #T#
#####################################################
