+---+---+---+---+---+---+---+---+---+---+---+---+---+---+---+---+---+---+---+---+---+---+---+---+---+---+
| O     |                   |                                       |           |                       |
+---+   +   +---+---+---+   +   +---+---+---+---+   +---+---+---+   +---+   +   +---+---+---+---+---+   +
|   |       |           |   |       |           |           |       |       |               |           |
+   +---+---+---+---+   +   +---+   +---+   +   +---+---+   +   +---+   +---+---+---+---+   +   +---+   +
|       |               |       |       |   |           |   |           |   |           |       |   |   |
+   +   +   +   +---+   +---+   +---+   +---+   +---+---+   +---+---+---+   +   +---+   +---+---+   +   +
|   |   |   |       |       |       |           |           |       |               |               |   |
+   +---+   +---+   +---+   +---+   +---+---+---+   +---+---+   +   +---+---+---+   +---+   +---+---+   +
|   |           |   |           |   |               |           |   |           |   |       |       |   |
+   +   +---+---+   +---+---+---+   +   +---+---+   +   +---+---+   +   +---+   +   +   +---+   +   +   +
|   |   |       |           |       |       |       |       |   |   |       |   |   |           |       |
+   +   +   +   +---+   +   +   +---+---+   +---+---+---+   +   +   +---+   +   +---+---+   +---+---+---+
|       |   |       |   |   |           |                   |   |           |           |   |           |
+   +---+   +---+   +   +   +---+---+   +   +---+---+---+---+   +---+---+---+---+---+   +   +---+---+   +
|   |       |       |   |       |   |   |       |               |                       |       |       |
+---+   +---+   +---+---+   +   +   +   +---+   +   +---+---+---+   +---+---+---+---+---+---+   +   +   +
|       |                   |   |   |   |   |   |   |           |       |   |               |   |   |   |
+   +---+---+---+---+---+---+   +   +   +   +   +   +   +---+   +---+   +   +   +   +---+   +   +   +---+
|           |                   |   |   |   |   |   |       |           |   |   |       |   |   |       |
+   +---+   +   +---+---+---+   +   +   +   +   +   +---+   +---+---+---+   +   +---+   +---+   +---+   +
|   |       |   |           |       |   |       |       |   |       |   |       |   |       |   |       |
+   +   +---+   +   +---+   +---+---+   +   +---+---+   +   +   +   +   +   +---+   +---+   +   +   +---+
|   |   |       |       |               |               |       |   |   |               |       |       |
+   +   +   +---+---+   +---+---+---+---+---+---+---+   +---+---+   +   +---+---+---+   +---+---+   +   +
|   |   |   |           |   |               |           |       |   |   |           |           |   |   |
+---+   +   +   +---+---+   +   +---+   +---+   +---+---+   +   +   +   +   +   +---+---+---+   +---+   +
|       |   |   |   |       |       |                   |   |   |   |   |   |               |       |   |
+   +---+   +   +   +   +   +---+   +---+---+---+---+   +---+   +   +   +   +---+   +---+   +---+   +   +
|   |       |   |       |               |       |               |   |   |       |       |       |   |   |
+   +---+---+   +---+---+   +---+---+---+   +   +---+---+---+   +   +   +---+   +---+   +---+---+   +   +
|   |       |           |   |       |       |           |   |   |   |       |   |   |   |       |       |
+   +   +   +---+---+   +---+   +   +   +---+---+---+   +   +   +   +   +   +   +   +   +   +   +---+   +
|       |           |           |       |   |       |   |       |   |   |   |   |   |       |       |   |
+   +---+---+---+   +---+---+---+---+---+   +   +   +   +---+   +   +---+   +   +   +---+---+---+   +   +
|   |           |           |               |   |   |       |   |   |       |                   |   |   |
+   +   +---+   +   +---+---+   +---+---+   +   +   +---+   +---+   +   +---+---+---+---+   +---+   +   +
|       |       |                   |       |   |       |   |       |                   |   |       |   |
+---+---+   +---+---+---+---+---+---+   +---+   +---+   +   +   +---+---+   +---+   +---+   +   +---+   +
|       |   |   |           |           |       |   |       |   |       |   |   |       |   |           |
+   +---+   +   +   +---+   +   +---+---+   +---+   +---+---+   +   +   +   +   +---+   +   +---+---+---+
|   |       |   |       |   |   |       |           |           |   |   |       |       |   |           |
+   +   +---+   +   +---+   +   +   +   +---+---+   +   +---+---+   +   +---+---+   +   +   +---+   +   +
|   |   |           |       |   |   |       |       |       |       |               |   |       |   |   |
+   +   +---+---+---+   +---+   +   +   +---+   +---+---+   +---+   +---+   +---+---+---+---+   +---+   +
|   |               |       |       |       |   |       |       |       |   |       |       |       |   |
+   +---+---+---+   +   +   +---+---+---+   +   +   +   +---+   +   +   +---+   +   +   +   +---+   +   +
|           |       |   |           |       |       |           |   |       |   |       |       |   |   |
+   +---+---+   +---+---+---+   +   +   +---+---+---+---+---+---+   +---+   +   +---+---+---+   +   +   +
|               |               |   |                   |       |   |   |       |           |   |       |
+   +---+---+---+   +---+---+---+   +---+   +---+---+---+   +   +   +   +---+---+   +---+   +   +---+   +
|                   |                   |                   |                       |       |         T |
+---+---+---+---+---+---+---+---+---+---+---+---+---+---+---+---+---+---+---+---+---+---+---+---+---+---+
