+---+---+---+---+---+
| O |           |   |
+   +   +---+   +   +
|   |       |       |
+   +   +   +---+---+
|   |   |           |
+   +   +---+---+   +
|   |           |   |
+   +---+---+---+   +
|                 T |
+---+---+---+---+---+
