###########################
#O# #           #         #
# # # ####### # ####### # #
# #     #     #       # # #
# # ##### ########### # # #
# # # #   # #     # #   # #
# # # # ### # # # # ##### #
# # # # #   # # #   #     #
# # # # # # # # ##### #####
# #   # # # # #     #   # #
# ### # # ### ##### ### # #
# #   # # #     #     #   #
# ##### # # ##### ####### #
# #   # #   #     #     # #
# # # # ##### ##### ### # #
#   # #     # #     #   # #
##### # ### # # ##### # # #
# #   #   # #   #     # # #
# # ##### # # ### ####### #
# #     # # # #   #       #
# ##### # # ### # # #######
#       # #   # # #   #   #
# ####### ### # ##### ### #
#   #   # #   # #   # #   #
### # # ### ### # # # # # #
#     #     #     #     #T#
###########################
