+---+---+---+---+---+---+---+---+---+---+---+---+---+
| O |           |                           |       |
+   +---+   +   +   +---+---+---+---+---+   +---+   +
|   |       |       |                   |           |
+   +   +---+---+---+   +---+---+   +---+---+---+   +
|   |   |           |   |       |   |               |
+   +   +   +   +   +   +   +   +---+   +---+---+---+
|       |   |   |       |   |           |   |       |
+---+---+---+   +---+   +   +---+---+---+   +   +   +
|               |   |   |   |       |       |   |   |
+---+   +---+---+   +   +   +   +   +---+   +   +   +
|       |       |       |       |       |       |   |
+   +---+   +---+   +---+---+---+---+   +---+---+   +
|   |               |           |       |       |   |
+   +   +---+---+---+   +   +   +   +---+   +   +   +
|   |   |               |   |   |           |       |
+   +---+   +---+---+---+   +---+---+---+---+---+   +
|       |       |       |   |                   |   |
+---+   +---+   +   +   +   +   +   +---+---+   +   +
|           |   |   |   |       |       |   |   |   |
+   +   +---+   +   +   +---+---+---+   +   +   +   +
|   |   |       |   |               |   |       |   |
+   +---+   +---+   +---+---+   +   +   +---+---+   +
|       |   |       |       |   |   |               |
+   +   +   +---+---+   +   +---+   +---+---+---+---+
|   |                   |                         T |
+---+---+---+---+---+---+---+---+---+---+---+---+---+
