+---+---+---+---+---+---+---+---+---+---+---+---+---+
| O     |               |               |           |
+---+   +   +   +---+   +---+   +---+   +---+---+   +
|   |   |   |   |       |       |                   |
+   +   +---+   +   +---+   +   +---+---+---+---+   +
|   |       |   |       |   |   |       |       |   |
+   +---+   +   +---+   +   +---+   +   +   +   +---+
|   |       |   |           |       |       |       |
+   +   +---+   +   +---+---+   +---+---+---+---+   +
|       |       |       |       |           |       |
+   +---+   +   +---+---+   +---+---+---+   +   +   +
|       |   |               |       |       |   |   |
+---+   +---+   +---+---+---+   +   +   +   +   +---+
|   |       |   |               |       |   |       |
+   +---+   +   +---+   +   +---+---+---+   +---+   +
|   |       |       |   |   |       |       |       |
+   +   +---+---+   +   +---+   +   +---+---+   +---+
|   |           |       |       |   |       |       |
+   +---+---+   +---+---+   +---+   +   +   +---+   +
|           |   |           |   |       |       |   |
+   +   +---+   +   +---+---+   +---+---+---+   +   +
|   |   |       |   |                       |       |
+   +   +   +---+   +   +---+---+   +   +---+---+   +
|   |   |           |   |           |   |           |
+   +---+---+---+---+   +   +---+---+---+   +---+---+
|                       |                         T |
+---+---+---+---+---+---+---+---+---+---+---+---+---+
