+---+---+---+---+---+---+---+---+---+---+---+---+---+
| O |   |                       |                   |
+   +   +   +---+---+---+   +   +---+---+---+   +   +
|   |           |           |               |   |   |
+   +   +---+---+   +---+---+---+---+---+   +   +   +
|   |   |   |       |   |           |   |       |   |
+   +   +   +   +---+   +   +   +   +   +---+---+   +
|   |   |   |   |       |   |   |       |           |
+   +   +   +   +   +   +   +   +---+---+   +---+---+
|   |       |   |   |   |   |           |       |   |
+   +---+   +   +   +---+   +---+---+   +---+   +   +
|   |       |   |   |           |           |       |
+   +---+---+   +   +   +---+---+   +---+---+---+   +
|   |       |   |       |           |           |   |
+   +   +   +   +---+---+   +---+---+   +---+   +   +
|       |   |           |   |           |       |   |
+---+---+   +   +---+   +   +   +---+---+   +   +   +
|   |       |       |   |       |           |   |   |
+   +   +---+---+   +   +   +---+   +---+---+---+   +
|   |           |   |   |   |       |               |
+   +---+---+   +   +   +---+   +   +   +---+---+---+
|               |   |       |   |   |       |       |
+   +---+---+---+   +---+   +   +---+---+   +---+   +
|       |       |   |       |   |       |   |       |
+---+   +   +   +---+   +---+   +   +   +   +   +   +
|           |           |           |           | T |
+---+---+---+---+---+---+---+---+---+---+---+---+---+
