#############
#S#   #     #
# # # # ### #
#   #   # # #
######### # #
#         # #
# ### ##### #
#   #       #
### #########
#   #       #
# ####### # #
#         #E#
#############
