+-+-+-+-+-+-+
|S|   |     |
+ + + + +-+ +
|   |   | | |
+-+-+-+-+ + +
|         | |
+ +-+ +-+-+ +
|   |       |
+-+ +-+-+-+-+
|   |       |
+ +-+-+-+ + +
|         |E|
+-+-+-+-+-+-+
