#############
#S  #     # #
### # # # # #
# # # # # # #
# # # # # # #
#   # # #   #
# ##### ### #
# #     # # #
# ### ### # #
# #   # #   #
# # ### # ###
#   #      E#
#############
