###############################
#S#       #   #             # #
# ####### # # # ####### ### # #
# #   #   # #   #   #   # #   #
# # # # ### ##### # # ### ### #
# # # #           # # #   #   #
# # # ############# # # # # ###
#   #             # # # #   # #
################# # # ### ### #
#       #   #     # #   #     #
# ##### # # # ######### ##### #
# #   #   # #     #     #   # #
# ### ##### ##### # ### # # # #
#       # #   #   # #   # # # #
####### # ### # ### # ### # # #
#   #   #   # # #   # #   # # #
# ### ### # # # # # ### ### ###
#   #     # #   # #       #   #
# # ####### ######### ####### #
# #       #         # #       #
# ### ### ######### ### ##### #
#   #   #         #   #   #   #
### ### # ####### ### # # # ###
#     # # #     #   # # # #   #
# ##### # # ### ### # ### #####
# #     # # # #   # #   #     #
# # ####### # ### ##### ##### #
# # #   #   #   #     #   #   #
# # # # # ### # ### ##### # # #
# #   #       #   #         #E#
###############################
