#######
#S    #
##### #
# #   #
# # ###
#    E#
#######
