+-+-+-+-+-+-+-+-+-+-+-+-+-+-+-+
|S    |   |           |       |
+-+-+ + +-+ +-+-+-+-+ + + +-+ +
|   | |     |     |   | | |   |
+ + + + +-+-+-+-+ + +-+ + +-+-+
| | | |   |     | |   | |     |
+-+ + +-+ + +-+ + +-+ + +-+-+ +
|   | |   | |   | |   | | |   |
+ +-+ + +-+ + +-+ + +-+ + + + +
|   | |     | |   |   |   | | |
+-+ + +-+-+-+ +-+ +-+ +-+ + +-+
|   |       |   |   |     |   |
+ + +-+-+-+ +-+ + +-+-+-+-+-+ +
| | |     |   |   |     |     |
+ +-+ + + +-+ + +-+ +-+ + +-+-+
|     | |   | | |   | | |     |
+-+-+ + +-+-+ +-+ +-+ + +-+-+ +
|   | |     | |   |   | |     |
+ + +-+-+-+ + + +-+-+ + + +-+ +
| | |     | |   |     | | |   |
+ + + +-+ + +-+-+ + +-+ + +-+ +
| |   |           | |   |   | |
+ +-+-+ +-+-+-+-+-+ + +-+-+ + +
| |   |   |   |     | |     | |
+ + + +-+-+ + +-+-+-+ + +-+-+ +
| | |   |   | |     |   |     |
+ + +-+ + +-+ + +-+ +-+-+ +-+-+
| |   |   | |   | |     | |   |
+ +-+ +-+-+ +-+-+ +-+-+ + + + +
|                     |     |E|
+-+-+-+-+-+-+-+-+-+-+-+-+-+-+-+
