+---+---+---+---+---+
| O |       |       |
+   +   +   +   +---+
|   |   |   |       |
+   +   +   +   +   +
|       |   |   |   |
+---+---+   +---+   +
|       |           |
+   +---+---+---+   +
|                 T |
+---+---+---+---+---+
