#############
#S#         #
# # ##### ###
# #     #   #
# # ####### #
# # #     # #
# ### ### # #
#     # #   #
####### ### #
#         # #
# ######### #
#          E#
#############
