+-+-+-+-+-+-+
|S|         |
+ + +-+-+ +-+
| |     |   |
+ + +-+-+-+ +
| | |     | |
+ +-+ +-+ + +
|     | |   |
+-+-+-+ +-+ +
|         | |
+ +-+-+-+-+ +
|          E|
+-+-+-+-+-+-+
