###############################
#S  #         #     #         #
### # ####### # # ### # ##### #
#   # #       # #     #   #   #
# ### # ########### ##### ### #
# #   # #         # #   #   # #
# ### # # ### ### # # ##### # #
#     # #   # #   # #   #   # #
####### ##### # ### ### # ### #
#     #       # #     # #   # #
# ### ######### ##### # ### # #
#   #         #     #     # # #
### ######### ##### ### ### # #
# #   #     #   #   # # #   # #
# ### # ##### ### ### # # ### #
#     #     #   #   #   # #   #
# ######### ### ### ##### # ###
#             #   #     # #   #
########### ##### ##### # ### #
#           #   #   # # #   # #
# ########### # # # # # ### # #
#   #     #   # # #   #     # #
### ### ### ### # ### ####### #
#   #   #   # #   # #   #     #
# ### ### ### ##### ### # #####
#   #   #   #           #   # #
### ### ### ### ##### ##### # #
#   #   # #   # #   # #   # # #
# ### # # ### ### # ### # # # #
#     #     #     #     #    E#
###############################
