###############################
#S# #           #             #
# # # ### ### ### ######### # #
# #     # #   #   #   #   # # #
# ### ### ##### ### # # # # # #
#   # #   #         # # # # # #
### # # ### ########### # # # #
#   # # #     #     #   #   # #
# ### # # ##### ### # ####### #
# #   #   #     # # #   #   # #
# ### ##### ##### # # # # # # #
#   #     #   #     # # # # # #
### ####### # # ####### # # # #
#   #     # # # #       # # # #
# ### ### # # # ### ##### # ###
# #   #   # # #   #   #   #   #
# # ### ### # ### ### # ##### #
# #   #   # # # #   #       # #
# ### ### # # # ### # ####### #
#   #   # # # #     # #       #
### # # # # # # ####### ##### #
#   # # # # # # #   #   #   # #
# ##### # ### # # # # ### # # #
#   #   # #   #   #   #   # # #
### # ### # ########### ##### #
# # #   #   #         #     # #
# # ### ##### ### ### # ### # #
# #     #   # # #   # # #   # #
# ####### ### # ### ### # ### #
#                 #     #    E#
###############################
