###########
#O# #     #
# # # ### #
# #   #   #
# ### # ###
#   # #   #
### # ### #
# # # #   #
# # ### # #
#       #T#
###########
