+-+-+-+-+-+
|O| |     |
+ + + +-+ +
| |   |   |
+ +-+ + +-+
|   | |   |
+-+ + +-+ +
| | | |   |
+ + +-+ + +
|       |T|
+-+-+-+-+-+
