+---+---+---+---+---+
| O |   |           |
+   +   +   +---+   +
|   |       |       |
+   +---+   +   +---+
|       |   |       |
+---+   +   +---+   +
|   |   |   |       |
+   +   +---+   +   +
|               | T |
+---+---+---+---+---+
