+---+---+---+---+---+
| O |               |
+   +---+---+   +   +
|           |   |   |
+---+---+   +   +   +
|       |       |   |
+   +   +---+---+   +
|   |       |       |
+   +---+---+   +---+
|                 T |
+---+---+---+---+---+
