###############################
#S#       #       #     #     #
# # # ##### ### # ### # ### # #
# # #     # #   #     #     # #
# # ##### # # # ############# #
# #     #   # # #   #       # #
# ##### ##### ### # ##### ### #
#     # #   #     #     #     #
##### # # ############# ##### #
#   # # #       #     #     # #
# # # # ### ### # ### ##### # #
# # # #     # # # #   #     # #
### # ####### # # # ### ##### #
#   # # #     # # # #   #   # #
# ### # # ### # # # # ### ### #
#     # # # #   # # # #     # #
# ##### # # ####### # ### # # #
#     # #         # #   # #   #
##### # ######### # ### #######
#   # # #         #   #       #
# ### # # ######### # ####### #
#   # #   #         #     #   #
### # # ### ##### ####### # ###
#   # #     #   # #     # #   #
# ### ##### # # ### ### ##### #
#   #     # # #   #   #     # #
# # ##### # # ### ### ##### # #
# #     # # # # #   #   # # # #
# # ##### ### # ### ### # # # #
# #           #         #    E#
###############################
