###############################
#S#       #       #           #
# ### ### # ### # ##### ##### #
#   #   #   #   #   #   # #   #
### ### ##### ##### # ### # ###
# #   #   #   #   # # #   # # #
# ### ##### ### # # # # ### # #
#   #       #   # #   #     # #
# # ######### ### ##### ##### #
# #   #       # #   # # #     #
### # ### ### # ### # # # # # #
#   #   # #   #   # # # # # # #
# ##### ### ### # # # # ### # #
# #   #     #   # # # #     # #
# # ######### # # # # ####### #
# #         # # # # # #       #
# # ### ### ### ### # # #######
# #   # #   #   #   # # #     #
# ##### # ### # # ### # # ### #
#     # #     # #   # # # #   #
##### # ####### ### # # # # ###
#     #     #   #     # # #   #
# ### ##### ##### ##### # ### #
# #   #   # #   # #   #   #   #
# # ### # # # # # # # ##### ###
# # #   # #   #   # #     #   #
# # # ### ######### # ####### #
# # #   #   #     # #       # #
# ##### ### # ### # ##### ### #
#         #     #       #    E#
###############################
