+-+-+-+-+-+-+-+-+-+-+-+-+-+-+-+
|S| |       |     |           |
+ + + +-+-+ + +-+ + +-+-+-+-+ +
| |   | |   |   | | |   |   | |
+ +-+ + + +-+-+ + + + + + +-+ +
|   |   | |     |   | |   |   |
+-+ +-+-+ + +-+-+-+-+ +-+ + +-+
|   |     |     |     |   |   |
+ +-+ +-+-+-+-+ +-+ +-+ +-+-+ +
| |     |     |     |   |   | |
+ + +-+ + + + +-+-+-+ +-+ + + +
| | | |   | |   | |   | | |   |
+ + + +-+-+ +-+ + + +-+ + +-+ +
| | |     |   | | | |   |   | |
+ + + +-+ +-+ + + + + + +-+ + +
| |   |   |   |   | | |   | | |
+ +-+-+-+-+ +-+-+-+ + +-+ + +-+
|   |   |   |       |   | |   |
+-+ + + + + + +-+-+-+-+ + +-+ +
| | | | | | | |         | | | |
+ + + + + +-+ + +-+-+-+-+ + + +
| | | |   |   | |   |   | | | |
+ + + +-+ + +-+ + + + + + + + +
|   |   | | |     | | |     | |
+ +-+ + +-+ +-+-+-+ + +-+-+-+ +
|   | |             | |       |
+-+ +-+-+-+-+-+-+-+-+-+ +-+-+ +
| | |             |     |   | |
+ + + +-+-+-+-+-+ + +-+-+ +-+ +
|     |             |        E|
+-+-+-+-+-+-+-+-+-+-+-+-+-+-+-+
