+-+-+-+-+-+-+-+-+-+-+-+-+-+-+-+
|S|         |       |   |     |
+ +-+-+-+ +-+ + +-+ + +-+ +-+ +
|   |   |     |   | | |     | |
+-+ + + +-+-+-+-+ + + + +-+-+ +
|   | | |         | |     |   |
+ +-+ + + +-+-+-+-+ +-+-+-+ + +
| |   |   | |       |       | |
+ + + +-+-+ + +-+-+-+ + +-+-+-+
| | | | |     |       | |     |
+ + + + + +-+-+ +-+-+-+ + +-+ +
| | | |   |     |     | | |   |
+ +-+ + +-+ +-+ + +-+ +-+ + + +
|     | |     |   | |   | | | |
+-+-+-+ +-+-+ +-+-+ +-+ + + + +
|     | |   |         | | | | |
+ +-+ + + + +-+ +-+-+-+ + + +-+
| |   | | |   | |     | | |   |
+ + + + + +-+ +-+ +-+ + + +-+ +
| | | | | |       | | | |   | |
+-+ + + + +-+-+-+-+ + + + +-+ +
|   | | |   |     |   |   |   |
+ +-+-+ +-+ + +-+ + +-+-+-+ +-+
|     |   | |   | | |     |   |
+-+-+ +-+ + +-+ + + + + + +-+ +
|     |   |   | | | | | |     |
+ +-+-+ +-+-+ + + + +-+ +-+-+ +
| |   | |   | | |   |   |   | |
+ + + + + + + + +-+-+ +-+ +-+ +
|   |     |   |       |      E|
+-+-+-+-+-+-+-+-+-+-+-+-+-+-+-+
