###############################
#S#         #       #   #     #
# ####### ### # ### # ### ### #
#   #   #     #   # # #     # #
### # # ######### # # # ##### #
#   # # #         # #     #   #
# ### # # ######### ####### # #
# #   #   # #       #       # #
# # # ##### # ####### # #######
# # # # #     #       # #     #
# # # # # ##### ####### # ### #
# # # #   #     #     # # #   #
# ### # ### ### # ### ### # # #
#     # #     #   # #   # # # #
####### ##### ##### ### # # # #
#     # #   #         # # # # #
# ### # # # ### ####### # # ###
# #   # # #   # #     # # #   #
# # # # # ### ### ### # # ### #
# # # # # #       # # # #   # #
### # # # ######### # # # ### #
#   # # #   #     #   #   #   #
# ##### ### # ### # ####### ###
#     #   # #   # # #     #   #
##### ### # ### # # # # # ### #
#     #   #   # # # # # #     #
# ##### ##### # # # ### ##### #
# #   # #   # # #   #   #   # #
# # # # # # # # ##### ### ### #
#   #     #   #       #      E#
###############################
