###############################
#S  #                   #   # #
### # # ############### # # # #
#   # # #             #   # # #
# ##### ##### ##### ####### # #
# #   #     # #   #           #
# # # # ### # # # ### #########
#   # #   # # # #   #     #   #
##### ### # # # ### ####### # #
#   #   # # # # # # #       # #
# # ### # # ### # # # ####### #
# #   # # #       # # #       #
# # ### ########### # # ##### #
# # #   #   #     #   # # #   #
### # ### # # ### # ### # # ###
#   #   # #   # # # #   #   # #
# ##### # ##### # # # ##### # #
# #   #   #     # # #     #   #
# # # ######### # ### ### ### #
#   #         # #   #   #   # #
####### ### # # ### ####### # #
#     # #   #   #   #     # # #
# ### ### ##### # ### ### # # #
#   #   # #     # #   # #   # #
# # ### # ##### # # ### ##### #
# #   #   #   # # #   #       #
# ### ### # # # # ### # #######
# # # #   # # # # #   #     # #
# # # ##### # ### # ####### # #
#   #       #       #        E#
###############################
