+-+-+-+-+-+-+-+-+-+-+-+-+-+-+-+
|S  |                   |   | |
+-+ + + +-+-+-+-+-+-+-+ + + + +
|   | | |             |   | | |
+ +-+-+ +-+-+ +-+-+ +-+-+-+ + +
| |   |     | |   |           |
+ + + + +-+ + + + +-+ +-+-+-+-+
|   | |   | | | |   |     |   |
+-+-+ +-+ + + + +-+ +-+-+-+ + +
|   |   | | | | | | |       | |
+ + +-+ + + +-+ + + + +-+-+-+ +
| |   | | |       | | |       |
+ + +-+ +-+-+-+-+-+ + + +-+-+ +
| | |   |   |     |   | | |   |
+-+ + +-+ + + +-+ + +-+ + + +-+
|   |   | |   | | | |   |   | |
+ +-+-+ + +-+-+ + + + +-+-+ + +
| |   |   |     | | |     |   |
+ + + +-+-+-+-+ + +-+ +-+ +-+ +
|   |         | |   |   |   | |
+-+-+-+ +-+ + + +-+ +-+-+-+ + +
|     | |   |   |   |     | | |
+ +-+ +-+ +-+-+ + +-+ +-+ + + +
|   |   | |     | |   | |   | |
+ + +-+ + +-+-+ + + +-+ +-+-+ +
| |   |   |   | | |   |       |
+ +-+ +-+ + + + + +-+ + +-+-+-+
| | | |   | | | | |   |     | |
+ + + +-+-+ + +-+ + +-+-+-+ + +
|   |       |       |        E|
+-+-+-+-+-+-+-+-+-+-+-+-+-+-+-+
