#######
#S#   #
# # # #
#   # #
##### #
#    E#
#######
