+---+---+---+---+---+
| O                 |
+---+---+---+---+   +
|               |   |
+   +---+   +   +   +
|   |       |   |   |
+   +   +---+---+   +
|   |   |           |
+   +   +   +---+---+
|   |             T |
+---+---+---+---+---+
