###############################
#S      #   # #               #
####### # # # # ############# #
#     #   # # # #       #   # #
# ### ##### # # ##### ### # # #
# # #   #   #   #     #   # # #
# # ### # ### ### # ### ### # #
#     # # # #     # #   #     #
####### # # ####### # ####### #
#     # # #       # #       # #
# ### # # # # ##### ####### ###
# #     # # #             #   #
# ####### ################### #
#       #             #       #
# ##### ############# # ##### #
# # #   #     #     # #     # #
# # # # # # ### # # # ##### # #
# # # #   # #   # # #     # # #
# # # ##### # ### # ##### # ###
#   # #   # # # # #     # #   #
# ### # ### # # # ##### # # # #
# #   # #   #   #   #   # # # #
### ### # ##### ### ### # # # #
#   #         #   #   # # # # #
# ### ####### ### ### ### # # #
# #   #   #     # #   #   # # #
# # ### # ### ### # ### ### # #
# # #   #   # #   #     #   # #
# ### ##### ### ############# #
#         #                  E#
###############################
