+---+---+---+---+---+
| O     |           |
+---+   +---+   +---+
|   |       |       |
+   +---+   +---+   +
|   |       |       |
+   +   +---+   +   +
|   |           |   |
+   +---+---+---+   +
|                 T |
+---+---+---+---+---+