+-+-+-+-+-+
|O|   |   |
+ + + +-+ +
|   |     |
+-+-+-+-+ +
|       | |
+ +-+-+-+ +
|       | |
+ +-+-+ + +
|     |  T|
+-+-+-+-+-+ 

┌┬┬┬┬┐
├  └ ┤
├┴┴┴┐┤
├ ┴┴┤┤
├ ┴┐ ┤
└┴┴┴┴┘


