 _________ 
|O|   |_  |
|___|___  | 
| ______| |
| ____  | |
|_____|__T|

