#############
#S  #     # #
### ### # # #
# #     # # #
# ####### # #
#       # # #
# ##### # # #
#   # #   # #
### # ##### #
# # #     # #
# # # ### # #
#     #    E#
#############
