#############
#S    #   # #
##### # # # #
#   # # #   #
# ### # #####
# #   #     #
# # ### ### #
# # #   #   #
# # ##### # #
# #       # #
# ######### #
#          E#
#############
