#############
#S  #       #
### # ##### #
# #   #     #
# ##### #####
#     #   # #
# ### ### # #
#   #     # #
### ####### #
#   #     # #
# ##### # # #
#       #  E#
#############
