###############################
#S#       #       #     #     #
# ### # ### ### # ### # ### # #
# #   # #   # # #     #   # # #
# # ##### ### # ######### # # #
# # #     #   # #       # # # #
# # # ####### # ####### # ### #
# #   #       # #     # #   # #
# ### ### ##### # ### # ### # #
#   #   #     # #   #     # # #
### ### ##### # # # ##### # # #
# # # # #     # # # #   # # # #
# # # # # # ### # # # # # # # #
# # # #   # #   # #   # # #   #
# # # # ##### ### ##### # ### #
#   #   #     # #   #   #   # #
# ####### ##### ### # ####### #
#   #   # # #   #   # #   #   #
### # # # # # # # ### # # # ###
# # # # # # # #   # #   #   # #
# # # # # # # ##### ######### #
# #   # # #   #           #   #
# ##### # ### # ####### # ### #
#       #   # #     #   #     #
# ######### # ##### # ####### #
#     #     #   #   # #     # #
##### ### ##### ##### # ### # #
#     #   # #   #     # #   # #
# ##### ### # ### ##### ##### #
#       #         #          E#
###############################
