###############################################
#O#         #               #   #         #   #
# ##### ### ######### ##### # # ####### # # # #
#     # #         #   #     # #         # # # #
##### # ######### # ### ##### ########### # # #
#     #       #   #   # #     #       #   # # #
# ####### ### # ##### # ### ##### ##### ### # #
# #     #   # #       # #   #   #       #   # #
# ### # ##### ######### # ### # ### ##### ### #
#   # #       #         #   # #   #   #     # #
### # ######### ######### # # ### ### ####### #
#   # #     # #   #   #   # # #   #   #     # #
# ### # ### # ### # # # ### # # ### ### ### # #
# #   #   #     # # # #   #   #   #   # #   # #
# # ### # ####### # ##### ####### ### # ### # #
#   #   #   #     #     # #     #   # #   #   #
##### ##### # ######### # # ### ### # ### ### #
# #   # #   # #   #     #   #   # # #     #   #
# # ### # ### # # # # ####### ### # ####### ###
#   #   #     # #   # #     #     #       #   #
# ##### ####### ####### ### ##### ####### ### #
# #     #   #         # # #     #       # #   #
# # ### # ### ####### # # ##### ####### # ### #
#   #   #   # #     #     #     #     # #   # #
##### ### # # # # ######### ### # ### # ### ###
# #   #   # #   # #   #     #   # #   #   #   #
# # ####### ##### # # # ##### ### # # ### ### #
# #   #   #     # # #   # #   #   # # # # # # #
# ### # # # ### # # ##### # ####### # # # # # #
#   # # #   #   # # #     # #       #   #   # #
# ### # ######### # # ##### # ####### ##### # #
#   # # #         # #     # # #     # #   # # #
# # # # # ######### ### # # # # ### # # # # # #
# # # #     #     #   # #     # # #   # #   # #
### # ##### # ### # # ######### # ##### ##### #
#   #   #   #   # # # #   #         #   # #   #
# ##### ####### # ### # # ########### ### # ###
#     #   #   # #   #   #       #   # #   #   #
##### ### # # # ### # ######### # # # # # ### #
#       #   # # # # #     #   #   #   # #   # #
# # ######### # # # ####### # ### ##### # ### #
# # #       # # #     #     #   #       # #   #
# ### ### ### # ##### # ####### ### ####### ###
#     # # #   #     #   #     # #   #     #   #
# ##### # # ####### ##### # ### ##### ### ### #
#       #           #     #           #      T#
###############################################
