###############################################
#O#       #   #         #             #       #
# ##### # # ### ##### # # ##### # ##### ### ###
# #     # # #   # #   # # #   # # #   # # #   #
# # ##### # # ### # ### ### # ### # # # # ### #
#   #   # #       # # #   # #   # # #   # #   #
##### # # ### ##### # ### # ### # # ##### # # #
#   # # #   # #   # #   #   #   #     #   # # #
# # # ##### # # # # # # ##### ####### # # # # #
# #   #     # # # # # #     #     #   # # # # #
# ### # ####### # # # ### ####### # ### # # ###
#   # #         #   #   # #       #   # # #   #
# # ################# ### # ######### ### ### #
# #     #   #     #   #   #     #   #     #   #
# ### # # # ### # ##### ####### # # ##### # # #
# #   #   #   # #   #   #       # # #   # # # #
# # ######### # ### # ### ####### # # # ### # #
# #     #   # #   # #   #         #   # #   # #
# ##### # # # # # # ### ############### # ### #
# # #   # # # # # #     #       #     #   #   #
# # # ### ### ### ####### ### ### ### ##### ###
#   # #     #   # #       # #   # #   #   # # #
### # # ### ### # # ####### ### # # # # ### # #
#   # # #   #   # #   #       #   # #   #   # #
##### ### ### ### ### ### ### ##### ### # ### #
#   #   #           #     # #     # #   # #   #
# # ### # ################# ##### # ##### ### #
# #   # # #   #   #       #     # #     #     #
# ### # # # # # # # # ##### # ### ##### ##### #
# # #   # # #   # # # #     # #   #   #   #   #
# # ##### # ##### # # # ##### # ### # # ### ###
# #       # #     # #   # #   #     # #     # #
# # ####### # ### # ##### # ######### ####### #
# #   #   # #   # # #     #     #     #       #
# ### ### # ### ### # ### ##### # ########### #
# #   #   # # #   # #   # #     #     #       #
# ### # ### # ### # # ### # ######### # ##### #
#   #   #   #   #   # #   #         #   #   # #
### ##### ### # ##### # # ##### ######### ### #
#   #     #   #   # # # # #   #   #           #
# ### ####### ### # # # # # # ### # ###########
#     #     # #   #   # #   # #   # #     #   #
# ####### # # # ####### # ##### # # # ### # # #
# #       # # #     #   # #     # #   # # # # #
# ##### ### # ##### # ### # ########### # # # #
#       #     #       #   #                 #T#
###############################################
