+---+---+---+---+---+---+---+---+---+---+---+---+---+---+---+---+---+---+---+---+---+---+---+
| O |                   |                               |       |                   |       |
+   +---+---+   +---+   +---+---+---+---+   +---+---+   +   +   +---+---+---+   +   +   +   +
|           |   |                   |       |           |   |                   |   |   |   |
+---+---+   +   +---+---+---+---+   +   +---+   +---+---+   +---+---+---+---+---+   +   +   +
|           |               |       |       |   |           |               |       |   |   |
+   +---+---+---+   +---+   +   +---+---+   +   +---+   +---+---+   +---+---+   +---+   +   +
|   |           |       |   |               |   |       |       |               |       |   |
+   +---+   +   +---+---+   +---+---+---+---+   +   +---+   +   +---+   +---+---+   +---+   +
|       |   |               |                   |       |   |       |       |           |   |
+---+   +   +---+---+---+---+   +---+---+---+---+   +   +   +---+   +---+   +---+---+---+   +
|       |   |           |   |       |       |       |   |   |       |       |           |   |
+   +---+   +   +---+   +   +---+   +   +   +   +---+   +   +   +---+   +---+   +---+   +   +
|   |       |       |           |   |   |   |       |       |       |       |   |       |   |
+   +   +---+   +   +---+---+---+   +   +---+---+   +---+---+---+   +---+   +   +---+   +   +
|       |       |       |           |           |   |           |       |   |       |       |
+---+---+   +---+---+   +   +---+---+---+---+   +   +   +---+   +---+   +   +---+   +---+   +
|   |       |   |       |   |       |           |       |       |   |   |           |       |
+   +   +---+   +   +---+   +   +   +   +   +---+---+---+   +---+   +   +---+---+---+   +---+
|       |       |           |   |       |   |           |           |               |       |
+   +---+---+   +---+---+---+   +---+---+---+   +---+   +---+---+   +---+---+---+   +---+   +
|   |           |       |                   |   |   |           |               |   |       |
+   +   +---+   +   +---+   +---+---+---+   +   +   +---+---+   +---+---+---+   +   +---+   +
|       |       |       |   |           |           |           |           |   |       |   |
+---+---+   +---+   +   +   +   +   +---+---+---+---+   +---+   +   +---+   +   +---+   +---+
|   |       |       |   |       |   |       |           |       |   |       |       |       |
+   +   +---+---+---+   +---+---+   +   +   +   +---+---+   +---+   +   +   +---+   +---+   +
|   |       |       |           |   |   |       |   |       |       |   |   |   |   |   |   |
+   +---+   +   +   +   +---+   +   +   +---+---+   +   +---+---+---+   +   +   +   +   +   +
|       |   |   |       |       |   |   |           |   |               |       |       |   |
+   +---+   +   +---+---+---+---+   +   +   +---+---+   +   +---+---+---+   +---+---+   +   +
|       |   |   |                   |   |           |   |   |           |   |       |   |   |
+   +   +   +   +   +---+---+---+---+   +---+   +   +   +   +   +---+   +   +   +   +   +   +
|   |   |   |           |           |       |   |           |   |   |       |   |       |   |
+---+   +   +---+---+   +   +---+   +   +   +---+---+---+---+   +   +---+---+   +---+---+   +
|       |       |       |       |   |   |   |       |                   |       |   |       |
+   +---+---+   +---+---+---+   +   +---+   +   +   +---+---+---+---+---+   +---+   +   +---+
|           |       |       |   |       |       |               |       |   |       |       |
+---+---+   +---+   +   +   +   +---+   +   +---+---+---+---+   +   +   +   +   +   +---+   +
|               |       |   |   |   |   |           |       |       |       |   |       |   |
+   +   +---+---+---+---+   +   +   +   +---+---+---+   +   +---+   +---+---+   +   +---+   +
|   |   |               |   |   |           |           |       |               |   |       |
+   +---+   +---+   +---+   +   +---+---+   +   +---+---+---+   +---+   +---+---+---+   +---+
|           |   |   |       |           |       |           |   |       |           |       |
+   +---+---+   +   +   +---+---+---+   +---+---+   +   +---+   +---+---+   +---+   +---+   +
|               |                       |           |                       |             T |
+---+---+---+---+---+---+---+---+---+---+---+---+---+---+---+---+---+---+---+---+---+---+---+
