+---+---+---+---+---+---+---+---+---+---+---+---+---+---+---+---+---+---+---+---+---+---+---+
| O             |   |                       |                   |                   |       |
+---+---+---+   +   +   +   +---+---+---+   +   +---+---+---+   +---+   +---+---+   +---+   +
|           |   |       |       |   |       |       |       |           |       |   |       |
+   +---+---+   +---+---+---+   +   +   +---+   +   +---+   +---+---+---+   +   +   +   +---+
|           |       |           |   |   |       |   |           |           |   |   |       |
+---+---+   +---+   +   +---+---+   +   +---+---+   +   +---+---+   +---+   +---+   +---+   +
|       |       |   |   |               |           |                   |           |       |
+   +   +   +   +   +   +---+   +---+---+   +---+---+---+   +---+---+---+---+   +---+   +---+
|   |   |   |   |   |       |           |       |       |   |       |       |   |           |
+   +   +   +   +   +   +   +---+---+   +---+   +   +   +---+   +   +   +   +   +---+   +   +
|   |       |   |   |   |   |       |       |       |           |       |   |       |   |   |
+   +---+---+---+   +   +   +   +---+---+   +---+---+---+   +---+---+---+   +---+   +---+   +
|   |               |   |   |           |               |       |       |   |       |       |
+   +   +---+---+---+---+   +   +---+   +---+---+---+   +---+   +---+   +   +---+   +   +   +
|   |   |                   |   |                   |   |               |       |       |   |
+   +   +   +---+---+---+---+   +   +---+---+---+   +   +---+---+   +---+---+   +---+---+   +
|   |   |           |       |   |               |   |           |   |       |       |   |   |
+   +   +   +---+   +---+   +   +---+---+---+   +   +---+---+   +   +   +   +---+   +   +   +
|   |   |   |       |       |   |               |   |       |   |   |   |       |   |       |
+   +   +---+   +---+   +---+   +   +   +---+---+   +---+   +   +---+   +---+   +   +---+---+
|       |       |   |       |   |   |   |       |           |   |       |       |           |
+   +---+   +---+   +   +   +   +   +   +   +   +   +---+---+   +   +---+   +---+---+   +   +
|           |           |       |   |   |   |   |   |           |       |           |   |   |
+---+---+---+   +---+---+---+---+   +   +   +   +---+   +---+---+   +   +---+---+   +---+   +
|           |   |       |           |   |   |           |       |   |   |       |       |   |
+   +---+---+   +   +---+   +---+---+   +   +---+---+---+   +   +   +   +---+   +---+   +   +
|   |       |   |       |   |           |       |       |   |       |   |           |       |
+   +   +   +   +---+   +   +   +---+---+---+   +---+   +   +---+---+   +   +---+---+---+   +
|       |   |       |   |   |   |           |       |   |       |       |                   |
+   +---+   +---+   +   +   +---+   +   +---+---+   +   +---+   +   +---+---+   +---+---+   +
|   |   |   |       |   |           |   |           |       |   |           |   |       |   |
+   +   +   +   +---+   +---+---+---+   +   +---+---+   +---+   +---+---+   +---+   +   +   +
|       |   |   |           |           |   |                   |       |           |   |   |
+---+   +   +   +---+---+   +   +---+   +   +   +---+---+---+---+   +   +---+---+---+   +   +
|       |       |           |   |       |   |       |               |   |               |   |
+   +---+---+---+   +---+---+   +---+   +   +---+   +---+   +---+   +   +   +---+---+---+   +
|       |                   |       |   |   |           |   |       |   |   |           |   |
+---+   +   +---+---+---+   +---+   +---+   +---+---+   +---+   +---+---+   +---+   +---+   +
|       |   |       |           |       |       |   |           |           |       |       |
+   +---+   +   +   +   +---+---+---+   +---+   +   +---+---+   +   +---+---+   +---+   +---+
|       |   |   |   |               |           |               |       |       |       |   |
+---+   +---+   +   +   +---+   +   +---+---+---+   +---+---+---+---+   +   +   +   +---+   +
|       |       |   |   |       |   |                   |           |   |   |   |           |
+   +---+   +---+   +---+   +---+   +---+---+---+---+---+   +---+   +   +   +---+---+---+   +
|           |               |                               |           |                 T |
+---+---+---+---+---+---+---+---+---+---+---+---+---+---+---+---+---+---+---+---+---+---+---+
