###############################################
#O      # #           #         #         #   #
####### # # # ####### # ####### ### ##### ### #
#     # #   #   # #   #   #   #     #   # #   #
# ##### ####### # # ### # ### ####### # # # ###
#     #   #     # # #   # #     #     # # #   #
##### ### # ##### # ##### # ##### ### ### ### #
#   #   # # #       #     #         #     #   #
# # # # # # ### ##### ####### ######### ### ###
# # # # # #   #     #   #   # #   #   # #     #
# # # # # # # ##### ### # # ### # # # # ### # #
# #   # # # # #   #   #   #     #   # #   # # #
# ####### # # # ##### ####### ####### ### ### #
# #       # # #     #       #   #   # #   #   #
# # ######### # ### ####### ### ### # ### # # #
# # #         # #         # #       #   #   # #
# # # ######### # ####### # ##### ##### ##### #
# # #     #   # #       # #     # #   #   # # #
# # # ### ### # ####### # ##### # # # ### # # #
# # # #   #   # #       # #   # # # #   # #   #
# # ### ### ### # # ##### ### # ### ### # #####
#   #   # #   # # # #   #     # #   #   #     #
# ### ### # # # # # # # # ##### # ### ##### # #
#     #     #   # # # # # #     #   #     # # #
####### ######### # # # ### ##### # ##### ### #
#     # #   #     # # #     #   # # #   #   # #
# ##### # ### ##### # ####### # # # ### ### # #
# #   # #   # #     #   #   # #   # #     #   #
# # # # ### # # ####### ### # ##### # ####### #
#   # #   # # # #     #   # #   #   #         #
# ### ### # # ### # ##### # ### # ##### ##### #
# # # #   # #     # #     #   # #     # #   # #
# # # # ### ####### # ##### ### ##### ### # # #
#   # # #     #     # #         #   #     # # #
### # # ##### # ### # # ######### # ####### # #
#   #   #     # #   # #   #       # #       # #
# ####### ##### ### # ### ### ### # # ####### #
#   #         #   # # #     # #   # # #     # #
### # ####### ### ### ##### ### ##### ### ### #
#   # #   #     #   #   # #     #     #   #   #
# ### # # # ####### ### # ##### # ##### ### ###
#   # # # #       #     #       #   #   #   # #
### ### # # ### # ####### ######### # # # ### #
#   #   # # #   # #         #     # # # #     #
# ### ### ### ### ########### ### # # ####### #
#     #       #               #     #        T#
###############################################
