+---+---+---+---+---+---+---+---+---+---+---+---+---+---+---+---+---+---+---+---+---+---+---+
| O |               |       |                   |                           |               |
+   +---+---+   +   +   +---+   +---+---+   +   +   +---+---+   +   +---+---+   +---+   +---+
|   |           |   |   |       |   |       |   |   |       |   |   |       |   |   |       |
+   +   +---+---+   +   +   +---+   +   +---+   +---+   +   +---+   +   +   +   +   +---+   +
|       |       |   |               |   |   |       |   |       |   |   |       |   |       |
+---+---+   +   +   +---+   +---+---+   +   +---+   +   +---+   +   +   +---+---+   +   +   +
|       |   |   |       |   |       |   |       |       |       |           |       |   |   |
+   +   +   +---+---+   +   +   +   +   +   +   +---+---+   +---+---+---+   +   +   +   +   +
|   |       |           |   |   |   |   |   |           |           |       |   |   |   |   |
+   +---+   +   +---+---+---+   +   +   +   +---+   +---+---+---+   +   +---+   +   +   +---+
|       |   |                   |       |       |   |               |       |   |   |       |
+   +   +---+---+---+---+---+---+---+---+   +---+   +   +---+---+---+---+   +---+   +---+   +
|   |           |       |           |       |       |           |       |           |       |
+   +---+   +   +   +   +---+   +   +---+---+   +---+---+---+   +   +   +---+---+   +   +   +
|   |       |       |       |   |       |       |               |   |   |       |   |   |   |
+   +   +---+---+---+---+   +   +---+   +   +---+   +---+---+---+   +   +   +   +---+   +   +
|   |           |       |   |       |   |       |                   |       |   |       |   |
+   +---+---+   +   +   +   +   +   +   +---+   +---+---+---+---+---+---+---+   +   +---+   +
|   |   |       |   |   |   |   |   |           |               |           |       |       |
+   +   +   +---+   +---+   +---+   +---+---+---+   +---+   +---+   +---+   +---+---+   +---+
|       |   |           |       |   |               |   |       |   |       |       |   |   |
+---+   +   +   +---+   +---+   +   +   +---+---+---+   +---+   +   +   +   +   +---+   +   +
|       |   |   |       |       |   |       |               |       |   |       |       |   |
+---+---+   +---+   +---+   +---+   +---+   +---+   +---+   +---+---+   +---+   +   +---+   +
|       |       |                       |           |   |           |   |       |   |       |
+   +   +---+   +   +---+---+---+---+---+---+---+---+   +---+---+   +   +---+---+   +---+   +
|   |       |   |   |       |       |               |           |   |           |           |
+   +---+   +   +   +   +   +   +   +   +   +---+---+   +   +---+   +---+---+   +---+---+   +
|   |   |       |   |   |       |   |   |   |           |   |       |       |       |       |
+   +   +---+---+   +   +---+---+   +   +   +   +---+---+   +   +---+   +   +   +---+   +---+
|   |               |   |           |   |       |   |       |           |   |           |   |
+   +   +---+---+---+   +   +---+   +   +---+---+   +   +---+---+---+---+   +---+---+---+   +
|   |       |       |   |       |   |   |           |           |           |               |
+   +---+   +---+   +   +---+   +---+   +   +---+   +---+---+   +   +---+---+---+---+---+   +
|   |       |       |   |   |       |   |       |   |           |           |               |
+   +---+   +   +---+   +   +---+   +   +   +---+   +   +---+---+---+---+   +   +---+---+   +
|       |       |       |       |       |   |       |                   |       |       |   |
+---+   +---+---+   +---+   +   +---+---+   +   +   +---+---+   +---+---+---+---+   +---+   +
|       |           |       |       |   |   |   |   |       |       |                       |
+   +---+   +---+---+---+   +---+   +   +   +   +   +   +   +---+   +   +---+---+---+---+---+
|           |           |   |       |       |   |       |   |       |   |           |       |
+   +---+---+---+   +   +   +   +---+---+---+   +   +---+---+   +   +   +   +---+   +   +   +
|   |               |   |   |           |       |   |           |   |       |   |   |   |   |
+   +---+---+   +---+   +   +---+---+   +   +---+   +   +---+---+---+---+---+   +   +   +   +
|               |           |               |       |                                   | T |
+---+---+---+---+---+---+---+---+---+---+---+---+---+---+---+---+---+---+---+---+---+---+---+
