+---+---+---+
| O         |
+---+---+   +
|       |   |
+   +   +   +
|   |     T |
+---+---+---+
