#######
#O    #
##### #
#   # #
# # # #
# #  T#
#######
