#######
#O    #
##### #
# #   #
# # ###
#    T#
#######
