#######
#O#   #
# # # #
# # # #
# # # #
#   #T#
#######
