+---+---+---+
| O         |
+---+---+   +
|   |       |
+   +   +---+
|         T |
+---+---+---+
