###############################
#S              #         #   #
############### # # ### ### # #
# #         # # # # #   #   # #
# # ##### # # # ### ##### ### #
# # #     # # #   #       #   #
# # # ##### # ### # ####### # #
# # # #   #   #   # #     # # #
# # # # # ##### ### # ### # ###
#   # # #   #   #   # #   #   #
# ### # ### # ### ### # ##### #
# #   # # #   #       #     # #
### ### # ################# # #
#   #   #           #     # # #
# # # ##### ####### ### ### # #
# # # #   #   #     #   #   # #
# ### # # ### # ##### ### ### #
#   #   # #   # #         #   #
### ##### # ### ######### # # #
#       #   # # #   #   # # # #
# ########### # # # # # ### # #
#             #   # # #     # #
# ########### ##### # ####### #
# #   #       #   # #   #   # #
# ### # # ##### # # # # # ### #
# #   # # #     #   # # # #   #
# # # # ### ########### # # ###
#   # #   # #       #   #   # #
##### ### # # ##### # ### ### #
#       #     #       #      E#
###############################
