###############################
#S  #   #       #         #   #
### # # # ##### ### ##### ### #
# #   # #     #     #         #
# ##### # ### ############### #
#     # # # #             # # #
# ##### # # ############# # # #
# #     # #   #   #   #   #   #
# # ##### # # # ### # # ### ###
# #   # # # #   #   #   #     #
# ### # # # ### # #############
#   # #     #   #             #
# ### ####### ######### ##### #
#   #       # #       #     # #
# # ####### ### ##### ##### # #
# # #     #   #   # # #   # # #
# # # ### ### ### # # # # # # #
# # #   #   #   # #     # # # #
# # ### ### ### # ####### # # #
# #     # #   # #     # # # # #
# ####### ### # ##### # # ### #
# #   #   #   #   #   # #     #
# # # ### # ##### # ### ##### #
# # #   # #     #   #     #   #
# # ### # ##### ##### ### # ###
# #   # #     #     #   # #   #
# ### # # ### ##### # # # ### #
#     #   # # #   #   # # #   #
########### # ### ##### ### ###
#                     #      E#
###############################
