+---+---+---+---+---+
| O     |   |       |
+---+   +   +   +   +
|       |       |   |
+   +---+---+---+   +
|       |       |   |
+---+   +   +   +   +
|   |   |   |   |   |
+   +   +   +   +   +
|           |     T |
+---+---+---+---+---+
