#########################################################
#O  #               #             #     #     #     #   #
### ### ########### ######### # ### # # ### # # ### # # #
# #     #         #   #     # #     # # #   # # #     # #
# ####### ##### ##### # ### ####### # # # ### # ####### #
#   #     #     #   # #   # #     # # #   # # #     # # #
### # ##### ##### # # ### # # ### ### ##### # ### # # # #
#   #   # #       # #     # # # #   #   #   #   # # #   #
# # ### # ######### ####### # # ### # # ### ### # # #####
# #   # #       #     #   #   #   # # # #     # # #     #
# ##### ####### # ### # # ####### # ### # ##### ### ### #
#     #       # #   #   #         #     #     #   #   # #
# ### ####### # ### ##### ####### ####### ### ### ##### #
# # #   #   # #   #   #   #   #   # #   #   #   #   #   #
# # # # # # # # # ### ### # # ### # # # # ##### ### # ###
#   # #   # # # #   #   # # #   #   # #   #     # # #   #
### # ##### # ### # ### # # ### ##### ##### ### # # ### #
#   #   #   # #   #   # # #   #   #   #   #   # # #     #
# ##### ##### # # ##### # ### ### # ##### ### # # ##### #
# #   #     # # # #   # # # #   #   #   #   # #   #     #
# ### ##### # # ### # # # # ### ##### # ### # ### # #####
#     #   #   #     # # # #   # #     #   # # #   #     #
##### # ######### ### # # ### # ##### ### # # # ####### #
# #   #         #   # # #   # # #   # # #   # # #       #
# # ### ##### # ##### # ### # # # # # # ### # ### #######
# # # # # #   #       #   #   # # # # #     #     #   # #
# # # # # # ######### ### ### # # # # # ########### # # #
# # #     #   # #     #   #   # # # # # #           # # #
# # ######### # # ##### ####### # # # # # ### ####### # #
# #           # # #   #       # # # # # #   #   #     # #
# ############# # ### ####### # # # # ##### ### # ##### #
# #       #     #   #       # # # # #     # # # #       #
# # # ### # # ##### ####### # # # # ##### # # # #########
# # # #     # #   #         # #   #     #     #     #   #
# # # ####### # # ##### ##### ######### ####### ### # # #
# # # #   # # # #     # #     #       #   #   #   #   # #
# # # # # # # # ##### # # # ### ##### ### # # ######### #
#   # # # # # # #   #   # # #   #     # #   # #     #   #
# ### # # # # # ### ##### # # ### ### # ##### # ### # # #
#   #   # #   #   # #   # # # # # #   #     #   # #   # #
### ##### ####### # # # # ### # # # ####### ##### ##### #
# # #   #         # # #   #   # # # #       #     #   # #
# # # ############# # ### # ### # # ### ### ##### # # # #
#   #               # #   #   # # # #   # #   #   # #   #
# ### ##### ####### # ####### # # # # ### ### # ### #####
# #       # #     # #     #     # #   # #     #   # #   #
# ######### ##### # ##### # ##### ##### # ##### # # ### #
# #   #     #   # #     #   # #   # #     #     # #   # #
# # # # ##### # # ##### ##### # ### # ####### ### ### # #
#   # #       # #     #     # #   #     #   # #     # # #
##### # ####### # # ####### # ### ##### # # ### ### # # #
#   # # #     # # #     #   # #   #   #   #     # # #   #
# ### # # ### # # ##### # ### # ### # ########### # ### #
#     # # #   # # #   # # #   # #   #   #   #         # #
# ####### # ### # # # # # ### # # ##### # # ########### #
#         #     #   # #       #       #   #            T#
#########################################################
