+---+---+---+---+---+---+---+---+---+---+---+---+---+---+---+---+---+---+---+---+---+---+---+---+---+---+---+---+
| O |               |               |               |       |           |               |                       |
+   +   +---+   +---+   +   +---+   +---+---+---+   +   +   +   +   +---+   +   +---+---+   +   +---+---+---+   +
|   |       |           |   |               |       |   |       |           |               |               |   |
+   +---+   +---+---+---+   +---+---+---+   +   +---+   +---+---+   +---+---+---+---+---+---+---+---+---+   +   +
|       |   |           |       |       |   |           |       |       |               |               |   |   |
+---+   +   +   +---+   +---+   +   +   +   +---+   +---+   +   +---+   +---+   +---+   +---+---+   +---+   +   +
|       |   |       |       |   |   |   |       |   |   |   |       |           |                   |       |   |
+   +---+---+---+   +---+   +   +   +   +---+   +   +   +   +---+   +---+   +---+---+---+---+---+---+   +---+   +
|   |               |   |       |   |           |       |   |       |       |               |           |       |
+   +---+   +---+---+   +---+---+   +---+---+---+   +---+   +   +---+   +---+   +---+---+   +   +---+---+   +---+
|   |       |               |       |       |       |       |       |       |   |           |   |       |       |
+   +   +---+   +   +---+   +   +---+   +   +---+---+   +---+---+   +   +---+   +   +---+---+   +   +---+---+   +
|       |       |   |       |           |   |           |       |   |   |       |               |           |   |
+---+---+   +---+   +---+---+---+---+---+   +   +---+---+   +   +   +   +   +---+---+---+---+---+   +---+   +   +
|   |       |   |               |       |   |   |           |   |   |   |   |       |               |   |   |   |
+   +   +---+   +---+---+   +---+   +   +   +   +   +---+   +   +   +   +   +   +   +   +---+---+---+   +   +   +
|   |           |       |   |       |       |   |   |       |   |   |   |   |   |       |   |           |   |   |
+   +---+---+   +   +   +   +   +---+---+---+   +   +   +---+   +   +---+   +   +---+---+   +   +---+   +   +   +
|               |   |   |       |               |   |   |       |   |       |       |               |   |       |
+   +---+---+---+---+   +---+---+   +---+---+---+   +   +---+   +   +   +---+---+   +---+   +---+---+   +---+---+
|       |                   |       |   |           |       |   |   |   |       |       |   |           |       |
+---+   +   +---+---+---+   +   +---+   +   +---+---+---+   +---+   +   +   +---+---+   +---+   +---+   +---+   +
|   |       |           |       |       |   |   |           |       |   |           |   |       |   |           |
+   +---+---+   +---+---+---+---+   +---+   +   +   +---+---+   +---+   +   +---+   +   +   +---+   +---+---+   +
|               |               |   |       |   |           |   |       |       |   |   |   |               |   |
+   +---+   +---+   +---+   +   +   +   +---+   +---+---+   +   +   +---+---+   +   +   +   +   +---+   +   +   +
|   |   |   |       |   |   |       |           |       |       |   |           |   |   |   |   |       |   |   |
+   +   +   +   +---+   +   +---+---+---+---+   +   +---+---+---+   +   +---+---+   +   +   +---+   +---+---+   +
|   |   |   |   |       |                   |   |                   |   |           |   |       |   |           |
+   +   +   +   +   +   +---+---+   +   +---+   +---+---+   +---+---+   +   +---+---+   +   +   +   +   +---+---+
|   |   |   |   |   |           |   |   |       |           |       |   |           |   |   |   |   |   |       |
+   +   +   +   +   +---+---+   +   +---+   +---+   +---+---+   +---+   +---+---+   +   +---+   +   +   +   +   +
|       |       |   |           |           |       |           |       |           |       |   |       |   |   |
+---+   +---+---+---+   +---+   +---+---+---+---+   +   +---+---+   +---+   +---+---+---+   +   +---+   +---+   +
|       |               |   |   |                   |               |   |           |       |       |           |
+   +---+---+---+   +---+   +   +---+   +   +---+---+   +---+---+---+   +---+---+   +   +---+---+   +---+---+   +
|   |       |       |       |       |   |   |       |   |                   |       |           |   |       |   |
+   +   +   +   +---+   +---+---+   +---+   +---+   +   +---+   +---+---+---+   +   +---+---+   +   +   +   +   +
|       |   |       |   |       |       |   |       |           |       |       |   |           |       |   |   |
+---+---+   +---+   +   +   +   +---+   +   +   +---+   +---+---+   +   +   +---+   +   +---+---+   +---+   +   +
|           |       |       |       |       |       |   |       |   |       |       |           |   |       |   |
+   +---+---+   +---+   +---+---+   +---+---+   +   +   +   +   +   +---+---+---+---+---+---+   +---+   +---+   +
|       |       |   |   |       |       |       |       |   |       |                   |   |           |   |   |
+---+   +---+   +   +   +---+   +---+   +   +---+---+---+   +   +---+   +---+---+   +   +   +---+---+---+   +   +
|   |           |   |           |   |       |           |   |   |       |           |           |       |   |   |
+   +---+---+---+   +---+---+   +   +---+---+   +---+   +   +   +   +---+   +---+   +---+---+   +   +   +   +   +
|   |           |           |   |   |           |       |   |   |   |   |       |   |       |       |   |   |   |
+   +   +   +   +   +---+---+   +   +   +---+   +---+---+   +---+   +   +---+   +---+   +   +---+---+   +   +   +
|   |   |   |       |           |       |   |   |           |       |   |       |       |   |       |       |   |
+   +   +   +---+   +   +---+---+---+   +   +   +   +---+---+   +---+   +   +---+   +---+   +   +   +---+   +   +
|   |   |   |       |       |       |       |   |       |       |       |   |       |   |       |   |       |   |
+   +   +   +---+---+---+   +   +   +---+---+   +---+   +   +---+---+   +   +   +---+   +---+---+   +---+---+   +
|       |   |           |   |   |   |       |       |   |   |           |   |       |           |   |       |   |
+   +---+   +   +---+   +   +   +   +   +   +---+   +   +   +   +---+   +   +---+   +---+---+   +   +   +   +   +
|       |           |           |       |           |           |       |                       |       |     T |
+---+---+---+---+---+---+---+---+---+---+---+---+---+---+---+---+---+---+---+---+---+---+---+---+---+---+---+---+
