+---+---+---+---+---+---+---+---+---+---+---+---+---+---+---+---+---+---+---+---+---+---+---+---+---+---+---+---+
| O |           |               |       |               |               |                               |       |
+   +---+---+   +   +   +---+   +   +   +   +---+   +   +   +---+   +   +   +---+---+---+   +---+---+   +---+   +
|   |       |   |   |   |   |   |   |       |       |   |   |       |   |   |           |       |           |   |
+   +   +   +   +   +   +   +   +---+---+---+   +---+   +   +   +---+   +   +---+---+   +---+   +---+---+   +   +
|       |   |       |   |   |   |               |       |   |       |   |           |       |       |   |   |   |
+---+---+   +---+---+   +   +   +   +---+---+---+   +---+   +---+   +   +---+---+   +---+   +---+   +   +   +   +
|       |               |   |       |   |           |       |   |   |           |       |       |   |           |
+   +---+---+---+---+---+   +---+---+   +   +---+---+   +---+   +   +---+---+   +---+   +   +   +   +---+---+   +
|               |           |               |       |   |       |   |               |       |   |       |   |   |
+   +---+   +   +---+---+   +   +---+---+---+   +   +   +   +---+   +---+   +---+---+---+---+   +---+   +   +   +
|   |   |   |               |       |           |   |   |       |       |   |               |   |       |       |
+   +   +   +---+---+   +---+---+   +   +   +---+---+   +---+   +---+   +---+   +---+---+   +   +   +---+   +---+
|       |       |       |           |   |   |               |       |           |       |   |   |   |           |
+---+   +---+   +---+   +   +---+---+---+   +   +---+---+   +   +   +---+---+---+   +---+   +   +   +---+---+   +
|       |   |       |   |       |       |       |       |       |   |           |       |       |       |       |
+   +---+   +---+   +---+---+   +   +   +---+---+   +   +---+---+   +   +---+   +---+   +---+---+---+   +   +---+
|   |           |               |   |   |           |       |   |   |       |       |   |           |   |   |   |
+   +---+---+   +---+---+---+---+   +   +   +---+---+---+   +   +   +---+   +---+   +   +   +---+   +   +   +   +
|           |       |       |       |       |           |   |   |           |           |   |   |       |       |
+---+---+   +   +   +---+   +   +   +---+   +   +---+   +   +   +---+---+---+   +---+---+   +   +---+---+---+   +
|   |       |   |       |   |   |       |   |       |   |   |   |               |           |                   |
+   +   +---+   +---+   +   +   +---+   +---+   +---+   +   +   +   +---+---+---+   +---+---+   +---+---+---+---+
|   |   |   |       |       |       |   |       |       |   |       |               |           |               |
+   +   +   +   +   +   +---+---+   +   +   +---+   +---+   +   +---+   +---+---+---+   +---+---+   +---+---+   +
|       |       |   |   |           |       |       |       |       |       |   |       |                   |   |
+   +---+---+---+   +   +   +---+---+---+---+   +---+   +---+---+---+---+   +   +   +---+---+---+---+---+---+   +
|               |   |   |   |       |       |       |                       |   |   |                       |   |
+---+---+---+   +   +---+   +   +   +   +   +---+   +---+---+---+---+---+---+   +   +   +---+---+---+---+   +   +
|           |   |       |   |   |       |       |           |                   |   |           |       |   |   |
+   +---+   +   +---+   +   +   +---+---+---+   +---+---+   +---+   +---+   +   +   +   +---+   +   +   +   +   +
|       |   |   |       |       |   |           |       |       |   |   |   |   |   |       |       |   |   |   |
+   +   +---+   +   +---+---+---+   +   +---+---+---+   +---+   +   +   +   +---+   +   +---+---+---+   +   +   +
|   |           |                                       |   |   |       |           |   |       |       |       |
+   +---+---+---+---+---+---+---+---+---+---+---+---+   +   +   +---+---+   +---+---+---+   +   +   +---+---+   +
|   |               |                               |   |   |           |   |           |   |   |           |   |
+   +---+---+   +   +   +---+---+---+---+---+---+   +   +   +---+---+   +   +   +---+   +   +   +   +---+   +   +
|   |           |   |   |   |                   |   |   |       |       |       |           |   |       |   |   |
+   +   +---+---+   +   +   +   +   +---+   +---+   +   +   +---+   +---+---+---+   +---+---+   +---+   +   +---+
|       |       |       |       |       |   |       |   |       |               |   |       |   |   |   |       |
+---+---+   +---+---+---+   +---+---+   +---+   +---+   +   +   +---+---+   +   +---+   +   +   +   +   +---+   +
|       |               |           |           |       |   |   |       |   |           |   |   |   |   |   |   |
+   +   +   +---+   +   +---+---+   +---+---+---+   +---+---+   +   +   +---+---+---+---+   +   +   +   +   +   +
|   |       |       |       |       |   |           |           |   |               |       |   |   |   |   |   |
+   +---+---+   +---+---+   +   +---+   +   +---+---+   +---+   +   +---+---+---+   +   +---+   +   +   +   +   +
|       |       |       |   |   |           |           |   |   |   |       |       |   |       |           |   |
+---+   +   +   +   +   +---+   +   +---+---+   +---+---+   +   +   +   +   +   +---+   +---+   +---+---+---+   +
|       |   |   |   |       |   |       |               |       |       |   |   |           |               |   |
+   +---+   +   +   +---+   +   +---+   +---+   +---+   +---+   +---+---+   +   +---+---+   +   +---+---+   +   +
|       |   |   |       |       |           |       |       |   |       |   |           |   |   |       |       |
+---+   +   +---+---+   +---+---+---+---+   +---+---+---+   +   +   +   +   +---+---+   +   +---+   +   +---+---+
|       |   |       |                   |                   |       |   |           |   |           |           |
+   +---+   +   +   +---+---+---+---+   +   +---+---+---+---+---+---+---+---+---+   +   +---+---+---+---+---+   +
|   |       |   |   |               |   |   |       |                   |       |   |                           |
+   +   +---+   +   +   +   +---+---+   +---+   +   +   +---+---+---+   +   +   +   +---+---+---+---+---+---+   +
|   |           |       |                       |       |                   |       |                         T |
+---+---+---+---+---+---+---+---+---+---+---+---+---+---+---+---+---+---+---+---+---+---+---+---+---+---+---+---+
