#########################################################
#O#       #       #       #   #     #       #           #
# # ### ### # ### ####### # # # # ### # ##### # ####### #
# #   #     # #       #   # #   #     #       #       # #
# ### ####### ####### # ### ##### ################### # #
#   # #     #   #   # #     #   #   #       #       # # #
### # # ### ### # # # ### ### # ### ### ### ##### ### # #
#   # #   #   # # # #   # # # #   #     #         #   # #
# ####### ### # # # ### # # # ### ### ############# ### #
# #       # #   # #     #   # #   #   #       #     #   #
# ### ##### ##### ####### ### # ### ### ##### # ##### ###
# #   #       #   #   #   #   #   #   # #     # #   #   #
# # ### # ### # ### # ##### ##### # ### # ##### # ##### #
#   #   # #   #     # #     #   # # #   #       #     # #
##### ### ########### # ##### # # # # ########### ### # #
# #   # #       #   # # #     # # # # #   #       # # # #
# # ### ##### ### # # # # ### # # # # # # # ####### # # #
# #     #   # #   #   # # #   # # # # # #   # #     # # #
# ##### # # # # ####### # # ### # ### # ##### # ### # # #
#       # # #   #       # # #   # #   #   #       # #   #
# ######### ##### ####### # ### # # ##### ### ##### #####
#   #         #   # #     #   # # # #   #   # #     #   #
### # ####### # ### # ####### ### # # ##### ### ### ### #
# #   #     #   #   # # #     #   # #     # #   # #     #
# ##### ######### ### # # ##### ### # ### # # ### ##### #
#       #       # #   # #     # #   #   # # # #       # #
# ### ### ### # # # ### ##### # # ##### # # # # ### # # #
# # # #   # # #   #     #   #   # #     # # # # #   # # #
# # # # ### # ######### # ####### # ##### # # ### ##### #
# # # # #   #         # #         # #     # #   # #     #
# # # # # # ##### # ### ##### ##### # ##### # # # # #####
# # # # # #     # # #   #     #   # #     # # # # # #   #
# # # # # ##### # ### ### ##### ### ##### # ### # # # # #
#   #   # #     #     #   #     #   #     #   # #   # # #
### ####### ### ######### # ##### ### ####### # ### ### #
#   #       # # #         #       # #     #   #   #     #
# ####### ### # ### # ##### ####### ##### # ##### ##### #
# #   #   #   #   # # #   # #         #   #     # #   # #
# # # # ### ##### ### ### # ### ####### # ##### # # # # #
#   # #   # #   #   # #   #     #   #   # #     #   # # #
##### ### # # # ### # # ### ##### # # ### # ##### ### # #
#     #   #   #   #   #   # #   # #   #   #     # #   # #
# ##### ### ##### ##### # # # # # ############# ### ### #
#   #   # # #   #   #   #   # #   #         # #     # # #
### ### # # ### ### # ####### # ### ##### # # ####### # #
# #     # #     # #   #     # # #   #     #     #   # # #
# ####### ##### # ##### ### # # # ### ### ##### # # # # #
# #     #     # # #     #   # # # # #   # #   #   # # # #
# # # # # ##### # # ### ##### ### # ### ### # ##### # # #
# # # #   #     #   # # #     #   # #   #   # #   #   # #
# # # ### # ####### # # # ##### ### # ### ### # # ### # #
# # # #   #   #   #   # #   #   #   # #   # #   # #   # #
# # # ####### # # ##### ### # ##### # # ### ##### ##### #
#   # #     # # # #   #   # # #     # #   #     # #   # #
# ### # ### # # # # # ### # # # ### # ### ##### # # # # #
#   #     #     #   #     #     #   #           #   #  T#
#########################################################
