#########################################################
#O#     #       #   #       #       #               #   #
# ##### # # ### # # # ### # # ### # # ####### ##### ### #
# #   # # # # # # #   #   # # #   # # #     #   #     # #
# # # # # # # # ####### ### # # ### # ##### ### ##### # #
#   # #   # # # #       #   # #   # #     #   #   # # # #
##### ##### # # # ####### ### ### # ##### ### ### # # # #
#   #       # #   # #     #   # # #     #   #   # #     #
# ########### ##### # ##### ### # ##### ### # # # ##### #
#       #     #       #   # #   # #       #   # #   # # #
# ### # ##### # ####### # # # ### ### ######### ### # # #
# # # #       #   #     # # #   #   # #       # #   #   #
# # # ##### ##### # # ##### ### ### ### ##### # # ### ###
#   #   #   #     # # #       #   #     #   # # # #     #
### ### ### # ####### # ##### # # ####### ### # # ##### #
#   # #   # #   #   #   #   #   # #     #   #   #   #   #
# ### ### ##### # # ##### # ##### # ### ### ####### # ###
# #     #       # # #     #   # # #   #   # #     # # # #
# ##### ######### # # ####### # # ### ### # # ### # # # #
#     #   #   #   #   #     # # #     #     # # #   #   #
##### # # ### # # ### # ### # # ####### ##### # ####### #
# #   # #   # # #   # #   # # # #       #     #         #
# # ### ### # # ### ### ### # # # ####### ##### #########
# # # #   #   #   # #   #   # #   #       #     #       #
# # # # # # ##### # # ### ### # ### ####### ##### ##### #
#   #   # # #     #   #   #   #   #   # #   #         # #
# ####### # # ######### ### ######### # # ############# #
#       # # # #   #   #   #           # # #           # #
####### # ### # # # # ### ############# # # ######### # #
#     # #   # # #   #   #     #         # #     #   # # #
# ### # ### # # ####### ##### ### ### # # # ### # # # # #
#   # # #   #   # #     #   #   # # # # # #   #   # # # #
# # ### # ####### # ####### ### # # # ### # ####### # # #
# #     #                   # # #   #     # #   #   #   #
# ######################### # # ##### ####### # # ##### #
# #       #               # # #     # #     # # #     # #
# ##### # # ############# # # ##### # # ### # # # ### # #
# #     # # # #         # # #   #   #   #     # #   # # #
# # ##### # # # # ### ### # # ### ####### ##### ### # ###
#   #   #   #   #   # #   # #   #       # #   # # # #   #
##### ####### ##### ### ### # # ##### # ### # # # # ### #
#   #       #     #     #   # # #   # #     # # # # # # #
# # # ### # ##### ####### ##### # # ######### # # # # # #
# #   #   #   #   # #     #     # #       #   # # # # # #
# ##### ##### # ### # ##### ### # ####### # ### # # # # #
#   #   #   # # #     #     # # # #   #   # #   #     # #
### # # # # ### # ##### ##### # # # # # ### ### ####### #
#   # # # #   # #   #       #   #   # # #     #       # #
# ### # # ### # ### ### ### ### ##### # ##### # ##### # #
#   # # #   #   #     #   #   # #   # #     # # #   #   #
### # ##### ######### ####### # # # # ##### # ### # #####
#   # #   #         #         #   # #     # #     #     #
# ### # # ######### # ################### # ########### #
# #   # # #       # # #   #         #   # #             #
# # ### # # # ##### ### # # ####### # # # ############# #
# #     #   #           #   #         #   #            T#
#########################################################
