#############
#S#         #
# ##### # # #
#     # # # #
##### # # ###
# #   # #   #
# # ### ### #
# # #     # #
# # ##### # #
# #   #   # #
# ### ##### #
#          E#
#############
