+---+---+---+---+---+
| O |               |
+   +---+   +---+   +
|           |   |   |
+---+---+---+   +   +
|               |   |
+   +---+   +---+   +
|   |   |           |
+   +   +---+---+---+
|                 T |
+---+---+---+---+---+
