+---+---+---+---+---+---+---+---+---+---+---+---+
| O |                   |               |       |
+   +---+---+---+   +   +   +---+   +   +   +   +
|   |           |   |       |       |   |   |   |
+   +   +---+   +   +---+---+   +---+   +---+   +
|   |   |   |   |           |   |   |       |   |
+   +   +   +   +---+   +---+   +   +---+   +   +
|   |   |           |   |       |       |       |
+   +   +---+---+   +---+   +---+---+   +---+   +
|   |       |   |           |               |   |
+   +   +   +   +---+---+---+   +   +---+---+   +
|   |   |   |               |   |       |       |
+   +---+   +   +---+---+   +   +---+   +   +---+
|           |       |       |       |       |   |
+---+---+---+   +   +   +---+---+   +---+---+   +
|           |   |   |       |       |           |
+---+---+   +   +   +---+---+   +---+   +   +   +
|           |   |       |       |       |   |   |
+   +---+   +   +---+   +   +---+   +---+   +   +
|   |       |       |   |   |           |   |   |
+   +---+---+---+   +   +   +---+---+---+   +---+
|   |               |   |               |       |
+   +   +---+---+---+   +---+---+---+   +---+   +
|                   |                         T |
+---+---+---+---+---+---+---+---+---+---+---+---+
