+---+---+---+---+---+---+---+---+---+---+---+---+
| O |               |                   |       |
+   +   +---+---+   +---+   +---+---+   +   +   +
|   |       |   |           |   |       |   |   |
+   +---+   +   +---+---+---+   +   +---+   +   +
|           |       |       |       |       |   |
+---+---+---+   +---+   +   +   +---+   +---+   +
|   |                   |   |           |   |   |
+   +   +---+---+---+---+   +---+---+---+   +   +
|       |           |       |                   |
+   +---+---+   +---+   +   +   +---+---+---+---+
|               |       |   |   |       |       |
+   +---+---+---+   +---+   +   +   +   +   +   +
|   |           |       |   |       |   |   |   |
+   +   +---+   +---+   +   +---+---+   +   +   +
|   |   |           |   |       |       |   |   |
+---+   +---+---+   +   +---+   +   +---+---+   +
|       |       |       |       |           |   |
+   +---+   +   +---+---+   +---+---+---+   +   +
|       |   |       |       |           |   |   |
+   +   +   +---+   +   +---+   +   +---+   +   +
|   |   |       |   |       |   |           |   |
+   +   +---+   +   +---+---+   +---+---+---+   +
|   |           |                             T |
+---+---+---+---+---+---+---+---+---+---+---+---+
