+---+---+---+---+---+---+---+---+---+---+---+---+
| O     |           |       |               |   |
+---+   +---+   +   +---+   +   +---+   +   +   +
|   |   |       |       |   |       |   |   |   |
+   +   +   +---+---+   +   +---+   +   +   +   +
|   |       |       |   |           |   |       |
+   +---+---+   +   +   +---+---+---+   +---+   +
|       |       |   |                   |       |
+   +   +   +---+   +---+---+---+---+---+   +---+
|   |       |               |               |   |
+   +---+---+   +---+---+   +   +---+---+---+   +
|       |       |           |       |           |
+---+---+   +---+   +---+---+---+   +---+   +   +
|           |       |           |       |   |   |
+   +---+   +---+---+   +   +---+---+   +---+   +
|   |       |           |           |           |
+   +---+---+   +---+---+---+---+   +---+---+   +
|   |       |       |           |       |   |   |
+   +   +   +---+   +   +   +---+   +   +   +   +
|       |       |   |   |   |       |       |   |
+   +---+---+   +   +---+   +   +   +---+---+   +
|   |           |   |       |   |   |           |
+   +   +---+---+   +   +   +   +---+   +---+---+
|   |                   |   |                 T |
+---+---+---+---+---+---+---+---+---+---+---+---+
