#########################
#O#       #         #   #
# # ##### ### ##### # # #
# #   # #     # #   # # #
# ### # ####### # ### # #
#     #   #   #   #   # #
####### ### # # ### ### #
# #         # #     # # #
# # ######### ####### # #
#   #     #   #         #
# ##### ### # # #########
#       #   # # #   #   #
# ####### ### # # # # # #
# #     #   # #   # # # #
# # ### ### # ##### # # #
# # #     # #   #   # # #
### ##### # ### # ##### #
#   #   #   #   #     # #
# ### # ##### ####### # #
#   # #   #   #     # # #
# # # ### # ### # ### # #
# # #   # #   # #     # #
# # ### # ##### ####### #
# #     #              T#
#########################
