#########################
#O#         #       #   #
# ####### # # ### # # # #
# #     # #   #   # # # #
# # ### # ##### ### ### #
# # # # #     # # #   # #
# # # # ### ### # ### # #
# # #     # #   #   #   #
# # ##### ### ##### ### #
# #   # #     #       # #
# # # # ####### # ##### #
# # # #       # #   #   #
# ### # ##### # ### # ###
#     #   #   #   #   # #
####### # # ##### ##### #
#     # # #   #   #     #
##### # # ##### ### # # #
#     # #   #   #   # # #
# ### # ### # ### ### # #
# #   #   # # #     # # #
# ####### # # ####### ###
# #       # #       #   #
# # ####### ####### ### #
#         #            T#
#########################
