###############################
#S#               #         # #
# ########### ### # ####### # #
#     #     # #   # #         #
##### # ### # # ### # #########
#   #   # # # #     #   #     #
# ####### # # ######### # ### #
# #   #     #     #   # #   # #
# # # # ##### ### # # # ### # #
#   # # # #   # #   # #   # # #
# ### # # # ### ##### ##### # #
#   # # #           #       # #
# ### # ########### ######### #
# #   #     #   #     #       #
# # ####### # # ####### ##### #
# #         # # #     #   # # #
# ########### # # ### ### # # #
# #   # #     #   #   #   #   #
# # # # # # ######### # ### ###
#   # #   #         # # #   # #
##### # ########### # # # ### #
#     # #           # # #   # #
# ####### ########### # ### # #
# #       #   #       #   #   #
# # ### ### # # ######### ### #
# # #   #   # # #         # # #
# ### ### ##### # ######### # #
#     #     #   #   #       # #
####### ### # ##### # # ##### #
#         #         # #      E#
###############################
