+---+---+---+---+---+
| O     |       |   |
+---+   +   +   +   +
|       |   |       |
+   +---+   +---+   +
|           |   |   |
+---+---+---+   +   +
|                   |
+   +---+---+---+---+
|                 T |
+---+---+---+---+---+
