+---+---+---+---+
| O     |       |
+---+   +   +   +
|       |   |   |
+   +---+   +   +
|   |       |   |
+   +---+---+   +
|             T |
+---+---+---+---+
