###############################
#S            #     #   #     #
############# # ### ### # ### #
#     #     # #   #   # #   # #
# ##### # # # ### ### # # ### #
#   #   # # #     #   # # #   #
# # # ### # ####### ### # # # #
# #   #   # #     # # #   # # #
# ##### ##### # ### # # ### ###
#   #   #     #     # # # #   #
##### ### ########### # # ### #
#     #   # #         #   # # #
# ##### ### # # ##### ### # # #
# #   # #     #   #     #   # #
# # # # ######### ####### ### #
#   # #     #   #     #   #   #
# ### ##### # # ##### # ### # #
# # #     #   #     #     # # #
# # ##### ######### # ##### # #
# #     #         # #   #   # #
# # ### ####### ### ### # #####
# #   # #     #     #   #     #
# ### # ##### ############### #
#   # #       #       #       #
### # ####### # ##### # ##### #
# #   #     # #     #   # #   #
# ####### # # # ### ##### # ###
#         # # # #   #     #   #
# # ######### ### ### ####### #
# #               #          E#
###############################
