#######
#S  # #
### # #
#   # #
# ### #
#    E#
#######
