###############################
#S  #             #     #     #
### ##### ####### # ### # # # #
# #     #     # # #   # # # # #
# ##### ##### # # ### # # # # #
#     # #   #   #   # #   # # #
### # # # # ### ### # ##### # #
#   # # # #   #   # # #     # #
# ##### # # # ### # # # ##### #
# #     # # # #   #   #     # #
# # ##### # ### ########### # #
#   #     #             #   # #
# ####### ########### ### ### #
#   #   #     #     # #   #   #
### # # ####### ### ### ### ###
# #   #         # #   # #   # #
# ############### ### # # ### #
#       # #         # # # #   #
# ##### # # ### ### # # # ### #
#   # # #     # #   # # #     #
### # # ####### ##### # #######
#   #     #     #     #       #
# ####### # ### # ##### ##### #
# #     #   #   # #       #   #
# # ### ######### ### ##### ###
# # #   #   #   #   # #   #   #
# # # ### # # # ### ### # ### #
#   # #   #   #   #   # #     #
# ### # ######### ### # ##### #
#   #           #       #    E#
###############################
