+-+-+-+-+-+-+
|S  |   |   |
+-+ + + +-+ +
| |   | |   |
+ +-+-+ + +-+
|       |   |
+ +-+-+-+-+ +
|   | |     |
+-+ + + + +-+
|   |   |   |
+ +-+-+-+-+ +
|          E|
+-+-+-+-+-+-+
