#############
#S  #   #   #
### # # ### #
# #   # #   #
# ##### # ###
#       #   #
# ######### #
#   # #     #
### # # # ###
#   #   #   #
# ######### #
#          E#
#############
