###########
#O#   #   #
# # # ### #
#   #     #
######### #
#       # #
# ####### #
#       # #
# ##### # #
#     #  T#
###########