+---+---+---+---+---+
| O |       |       |
+   +   +   +---+   +
|       |           |
+---+---+---+---+   +
|               |   |
+   +---+---+---+   +
|               |   |
+   +---+---+   +   +
|           |     T |
+---+---+---+---+---+
