#######
#O#   #
# ### #
#     #
##### #
#    T#
#######
