+---+---+---+
| O |       |
+   +---+   +
|           |
+---+---+   +
|         T |
+---+---+---+
