+---+---+---+---+---+
| O |               |
+   +---+---+---+   +
|                   |
+---+---+---+---+   +
|               |   |
+   +   +---+---+   +
|   |   |           |
+   +   +   +---+---+
|   |             T |
+---+---+---+---+---+
