+---+---+---+---+---+---+
| O |                   |
+   +   +---+---+---+   +
|   |       |       |   |
+   +---+   +   +   +---+
|       |   |   |       |
+---+   +   +   +---+   +
|   |   |           |   |
+   +   +   +---+---+   +
|   |   |   |           |
+   +   +---+   +---+   +
|               |     T |
+---+---+---+---+---+---+
