#############
#O    #     #
##### # ### #
#   # # #   #
# # # # # ###
# # # # #   #
# # # # ### #
# # # #   # #
### # ### # #
#   #     # #
# ######### #
#          T#
#############
