+---+---+---+---+---+---+
| O     |               |
+---+   +---+---+   +---+
|   |   |       |       |
+   +   +   +   +---+   +
|   |   |   |           |
+   +   +   +---+---+   +
|   |       |       |   |
+   +---+---+   +   +   +
|           |   |   |   |
+   +---+---+   +   +   +
|               |     T |
+---+---+---+---+---+---+
