#############
#O#         #
# # ####### #
# #   #   # #
# ### # # ###
#   # # #   #
### # # ### #
# # #     # #
# # # ##### #
# # # #     #
# # ### ### #
#       #  T#
#############
