+---+---+---+---+---+---+
| O         |           |
+---+---+   +   +---+   +
|       |   |   |       |
+   +   +   +   +   +---+
|   |   |   |   |       |
+   +   +   +   +---+   +
|   |   |   |       |   |
+---+   +   +---+   +   +
|       |           |   |
+   +---+---+---+---+   +
|                     T |
+---+---+---+---+---+---+
