+-+-+-+-+-+-+-+-+-+-+-+-+-+-+-+
|S  |         |   |   |       |
+-+ +-+ + +-+ + + + + + + +-+ +
| |   | | | | | |   |   | |   |
+ +-+ + + + + + +-+-+-+-+ + +-+
|   | | | | | |   |       |   |
+ +-+ + + + + +-+ + +-+-+-+-+ +
| |   | | | |   | |       | | |
+ + +-+ + + +-+ +-+-+-+-+ + + +
| |   | | |     |         |   |
+ +-+ +-+ + +-+-+ +-+-+-+-+-+-+
|   |   | |   |     |         |
+ +-+-+ + +-+ +-+-+ + +-+-+-+ +
| |   | | |   |   |       |   |
+ + + + + + +-+ + +-+ +-+-+ + +
|   | |   | |   |   | |     | |
+ +-+ +-+-+ + +-+-+ +-+ +-+-+ +
| |   |     |     | |   | |   |
+ + +-+ +-+-+-+-+ + + +-+ + +-+
| |   |       |   |   | |   | |
+ +-+ +-+-+-+ + +-+-+-+ + +-+ +
|   |   |   | | |       | |   |
+-+ +-+ + + + + +-+-+ + + +-+ +
| | | |   |   | |     | |     |
+ + + +-+-+-+-+ + +-+-+ +-+-+ +
| |   |       | |     |   |   |
+ +-+ + +-+ + + +-+-+ +-+-+ +-+
| |   |   | | |   |   |     | |
+ + +-+-+-+ + +-+ + +-+ +-+-+ +
|           |     |          E|
+-+-+-+-+-+-+-+-+-+-+-+-+-+-+-+
