###############################
#S  #         #   #   #       #
### ### # ### # # # # # # ### #
# #   # # # # # #   #   # #   #
# ### # # # # # ######### # ###
#   # # # # # #   #       #   #
# ### # # # # ### # ######### #
# #   # # # #   # #       # # #
# # ### # # ### ######### # # #
# #   # # #     #         #   #
# ### ### # ##### #############
#   #   # #   #     #         #
# ##### # ### ##### # ####### #
# #   # # #   #   #       #   #
# # # # # # ### # ### ##### # #
#   # #   # #   #   # #     # #
# ### ##### # ##### ### ##### #
# #   #     #     # #   # #   #
# # ### ######### # # ### # ###
# #   #       #   #   # #   # #
# ### ####### # ####### # ### #
#   #   #   # # #       # #   #
### ### # # # # ##### # # ### #
# # # #   #   # #     # #     #
# # # ######### # ##### ##### #
# #   #       # #     #   #   #
# ### # ### # # ##### ##### ###
# #   #   # # #   #   #     # #
# # ####### # ### # ### ##### #
#           #     #          E#
###############################
