+-+-+-+-+-+-+-+-+-+-+-+-+-+-+-+
|S  | |           | |         |
+-+ + + +-+-+ +-+ + + + +-+-+-+
| | |   |   | | | |   |       |
+ + +-+-+ + + + + +-+ +-+-+-+ +
| |       |   | |   |     |   |
+ +-+-+-+-+-+-+ +-+ +-+-+-+ + +
|     |           |   |     | |
+-+ + +-+-+ +-+-+-+-+ + +-+-+ +
|   |       |       |   |   | |
+ +-+-+-+-+-+ +-+ + +-+-+ +-+ +
| |         |   | |       |   |
+ + +-+-+-+ +-+ + +-+-+-+-+ +-+
|   |     | |   | |       |   |
+ +-+ +-+ + + +-+ + +-+-+ +-+ +
|   | | | |   | |   |   |     |
+-+ + + + +-+-+ +-+-+ +-+-+-+-+
| | |   |   |     |           |
+ + +-+-+ + +-+ + +-+-+-+-+-+ +
| |   |   |   | | |   |     | |
+ +-+ + +-+-+ + + + + + +-+ + +
|   |   |     | |   |   | | | |
+ + +-+-+ +-+-+ +-+-+-+-+ + + +
| |   |   |     |       |   | |
+ + + + +-+ +-+ + +-+-+ + +-+ +
| | | |   | |   | |   | | |   |
+ + + +-+ +-+ +-+ + + + + + + +
| | |   |   | | |   | | |   | |
+ + +-+-+-+ + + +-+-+ + +-+-+ +
| |           |       |      E|
+-+-+-+-+-+-+-+-+-+-+-+-+-+-+-+
