###############################
#S  # #           # #         #
### # # ##### ### # # # #######
# # #   #   # # # #   #       #
# # ##### # # # # ### ####### #
# #       #   # #   #     #   #
# ############# ### ####### # #
#     #           #   #     # #
### # ##### ######### # ##### #
#   #       #       #   #   # #
# ########### ### # ##### ### #
# #         #   # #       #   #
# # ####### ### # ######### ###
#   #     # #   # #       #   #
# ### ### # # ### # ##### ### #
#   # # # #   # #   #   #     #
### # # # ##### ##### #########
# # #   #   #     #           #
# # ##### # ### # ########### #
# #   #   #   # # #   #     # #
# ### # ##### # # # # # ### # #
#   #   #     # #   #   # # # #
# # ##### ##### ######### # # #
# #   #   #     #       #   # #
# # # # ### ### # ##### # ### #
# # # #   # #   # #   # # #   #
# # # ### ### ### # # # # # # #
# # #   #   # # #   # # #   # #
# # ####### # # ##### # ##### #
# #           #       #      E#
###############################
