+---+---+---+---+---+
| O     |           |
+---+   +   +---+   +
|   |   |   |       |
+   +   +   +   +---+
|       |   |       |
+   +---+   +---+   +
|           |   |   |
+---+---+---+   +   +
|                 T |
+---+---+---+---+---+
