#############
#S        # #
######### # #
#     #   # #
# ### # ### #
#   #   #   #
### ####### #
# #   #   # #
# ### # # # #
#     # # # #
# ##### # # #
#       #  E#
#############
