+---+---+---+---+---+
| O     |           |
+---+   +   +   +   +
|       |   |   |   |
+   +---+---+   +   +
|   |           |   |
+   +   +---+---+   +
|   |           |   |
+   +---+---+   +   +
|               | T |
+---+---+---+---+---+
