###############################
#S  #         #     #     #   #
### ####### # # ### # ### # # #
# #         #   # # #   # # # #
# ############### # ### # ### #
#         #       # #   #   # #
# # ##### # ####### # ##### # #
# # #   #   #     # #     #   #
# ### # ##### ### # ##### ### #
#     # #     # # #     #   # #
# ##### # ##### # ##### # # ###
# #   #   #     #     # # #   #
# # # ##### ### ### ### # ### #
#   #       # #   #     # #   #
############# ### ######### # #
# #       #   #   #         # #
# # # ### ### # ### ##### ### #
# # # #   #   # # #   #   #   #
# # # ### # ### # ### # ##### #
#   #   # # #   #     # #   # #
# ##### # # # ### ##### # # ###
# #   # # # #   #   # #   #   #
# # # # # # ### ### # ####### #
# # #   #   # # #     #   #   #
### ####### # # ####### # # # #
#   #         #         # # # #
# # ##################### # # #
# # #     #     #       # # # #
# ### ### # # ### ### ### # # #
#       #   #       #       #E#
###############################
