+-+-+-+-+-+-+-+-+-+-+-+-+-+-+-+
|S  |         |     |     |   |
+-+ +-+-+-+ + + +-+ + +-+ + + +
| |         |   | | |   | | | |
+ +-+-+-+-+-+-+-+ + +-+ + +-+ +
|         |       | |   |   | |
+ + +-+-+ + +-+-+-+ + +-+-+ + +
| | |   |   |     | |     |   |
+ +-+ + +-+-+ +-+ + +-+-+ +-+ +
|     | |     | | |     |   | |
+ +-+-+ + +-+-+ + +-+-+ + + +-+
| |   |   |     |     | | |   |
+ + + +-+-+ +-+ +-+ +-+ + +-+ +
|   |       | |   |     | |   |
+-+-+-+-+-+-+ +-+ +-+-+-+-+ + +
| |       |   |   |         | |
+ + + +-+ +-+ + +-+ +-+-+ +-+ +
| | | |   |   | | |   |   |   |
+ + + +-+ + +-+ + +-+ + +-+-+ +
|   |   | | |   |     | |   | |
+ +-+-+ + + + +-+ +-+-+ + + +-+
| |   | | | |   |   | |   |   |
+ + + + + + +-+ +-+ + +-+-+-+ +
| | |   |   | | |     |   |   |
+-+ +-+-+-+ + + +-+-+-+ + + + +
|   |         |         | | | |
+ + +-+-+-+-+-+-+-+-+-+-+ + + +
| | |     |     |       | | | |
+ +-+ +-+ + + +-+ +-+ +-+ + + +
|       |   |       |       |E|
+-+-+-+-+-+-+-+-+-+-+-+-+-+-+-+
