###############################
#S  #                 #       #
### # ######### ##### ### #####
#   # #     #   #   #   #     #
# ##### ### # ### # ### ##### #
# #     # # #     # # # #   # #
# # ##### # ####### # # # # # #
# #     # # #       # #   #   #
# ### # # # # ####### # #######
#   # # #     #   #     #     #
### ### ####### # ####### ### #
# #   #       # # #   #     # #
# ### ####### # # # # # ##### #
#   #   #   #   #   #   # #   #
# ##### # # ##### ####### # ###
#       # #     # #       #   #
# ####### ##### # ### ### ### #
#   # #     #   #   # #     # #
### # # ### # ##### # # ##### #
# # # # #   # #   # # #   #   #
# # # # # ### # # # ### # # # #
# # #   # # #   # #   # # # # #
# # ##### # ##### ### ### # # #
#   #   # #         #     # # #
# ### # # # ####### ####### # #
#     # # #   #   #     #   # #
####### # ##### # ##### # ### #
#     # #       #   # # #   # #
# ### # ########### # # ### # #
#   #               #       #E#
###############################
