+-+-+-+-+-+-+-+-+-+-+-+-+-+-+-+
|S  |                 |       |
+-+ + +-+-+-+-+ +-+-+ +-+ +-+-+
|   | |     |   |   |   |     |
+ +-+-+ +-+ + +-+ + +-+ +-+-+ +
| |     | | |     | | | |   | |
+ + +-+-+ + +-+-+-+ + + + + + +
| |     | | |       | |   |   |
+ +-+ + + + + +-+-+-+ + +-+-+-+
|   | | |     |   |     |     |
+-+ +-+ +-+-+-+ + +-+-+-+ +-+ +
| |   |       | | |   |     | |
+ +-+ +-+-+-+ + + + + + +-+-+ +
|   |   |   |   |   |   | |   |
+ +-+-+ + + +-+-+ +-+-+-+ + +-+
|       | |     | |       |   |
+ +-+-+-+ +-+-+ + +-+ +-+ +-+ +
|   | |     |   |   | |     | |
+-+ + + +-+ + +-+-+ + + +-+-+ +
| | | | |   | |   | | |   |   |
+ + + + + +-+ + + + +-+ + + + +
| | |   | | |   | |   | | | | |
+ + +-+-+ + +-+-+ +-+ +-+ + + +
|   |   | |         |     | | |
+ +-+ + + + +-+-+-+ +-+-+-+ + +
|     | | |   |   |     |   | |
+-+-+-+ + +-+-+ + +-+-+ + +-+ +
|     | |       |   | | |   | |
+ +-+ + +-+-+-+-+-+ + + +-+ + +
|   |               |       |E|
+-+-+-+-+-+-+-+-+-+-+-+-+-+-+-+
