+---+---+---+---+---+
| O         |       |
+---+---+   +   +---+
|       |   |       |
+   +   +   +   +   +
|   |   |   |   |   |
+   +   +   +---+   +
|   |   |           |
+   +   +---+---+   +
|   |             T |
+---+---+---+---+---+
