#############
#S#   #     #
# # # ##### #
# # #   #   #
# # ### # ###
#   # # #   #
##### # ### #
#     #   # #
# ### ### # #
#   #   # # #
# # ##### # #
# #        E#
#############
