###############################
#S  #     #   # #       #     #
### # ### # # # # # ##### # # #
# #   # #   # # # #       # # #
# ##### ##### # # ######### ###
# #       #   # # #       #   #
# # ##### # ### # ####### ### #
#   #   # # #   #           # #
# ### ### # # ######### ##### #
# #   #   # #       #   #   # #
# # # # # # ####### # ### # # #
# # # # # # #     #   #   #   #
# ### # ### # ### # ### #######
# #   #   #   # # # # #       #
# # # ### ##### # # # ####### #
# # #   #     #   # #   #   # #
# # ####### ### ### # # # ### #
# #       #     # # # #   #   #
# ### # ######### # # ### # ###
#   # #       #   #   #   #   #
### ##### ### # ####### ##### #
# # #   # # # # #           # #
# # # # # # # # # ####### ### #
# #   # # # # #   # #   # #   #
# ##### # # # # ### # # ### # #
# #     # # # #     # # #   # #
# # ##### # # ##### # # # ### #
# #       # #     # # #   # # #
# ######### ##### ### ##### # #
#                     #      E#
###############################
