+---+---+---+---+---+
| O     |           |
+---+   +---+   +   +
|   |       |   |   |
+   +---+   +   +   +
|   |       |   |   |
+   +   +---+---+   +
|   |           |   |
+   +---+---+   +   +
|                 T |
+---+---+---+---+---+
