+---+---+---+---+---+
| O |       |       |
+   +   +   +   +   +
|       |       |   |
+---+---+---+---+   +
|               |   |
+---+   +---+---+   +
|       |       |   |
+   +---+   +   +   +
|           |     T |
+---+---+---+---+---+
