#############
#S    #     #
##### ##### #
#   # #   # #
# # # # # # #
# #   # #   #
# ##### ### #
#   #   #   #
### # ##### #
# # #     # #
# # ##### # #
#         #E#
#############
