#######
#S#   #
# ### #
#     #
##### #
#    E#
#######
