+-+-+-+-+-+-+
|S  |       |
+-+ + + +-+ +
|   | | |   |
+ +-+ + + +-+
|   | | |   |
+-+ + + +-+-+
|   | |     |
+ +-+-+-+-+ +
| |         |
+ +-+ +-+-+ +
|     |    E|
+-+-+-+-+-+-+
