#############
#S  #       #
### # # ### #
#   # # #   #
# ### # # ###
#   # # #   #
### # # #####
#   # #     #
# ######### #
# #         #
# ### ##### #
#     #    E#
#############
