###############################
#S#   #         #   #   # #   #
# # # # ####### # # # # # # # #
#   # #     # #   #   # #   # #
##### ##### # ######### # ### #
#   #   #   # #       # # # # #
### ### # ### # ### ### # # # #
#   # # # #     # #     #   # #
# # # # # # ##### ########### #
# #   #   # #   #             #
# ######### # # ### # ####### #
# #       #   #   # # #     # #
# # ### # ####### ### # # ### #
# # #   #       #     # #   # #
# # # ################# ### # #
#   # #       #       #   # # #
# ### # ##### # # ### ### # # #
# #   # #   #   # #     # #   #
### # # ### ##### # ##### #####
#   # #     # #   #   #   #   #
# # ####### # # ##### # ### ###
# # #   #   # # #   # #   #   #
# ### # # ### # # # # ### ### #
#     #   #   # # #   #   #   #
# ######### # # ####### ### # #
# #     #   # #         #   # #
# # ### # ############### #####
# # #   #               #     #
# # # ############# ### ##### #
#   #               #        E#
###############################
