###############################
#S#             #     #       #
# ##### ##### # # ### ##### # #
# #   # #     #   # #     # # #
# # # ### ######### ##### ### #
# # #     #     #       #   # #
# # ####### ### # ##### ### # #
# #   #   # # #   #   #   # # #
# # # ### # # ##### # # # # # #
# # #   #           # # # # # #
# ##### # ############# # # # #
#       # #         #   # #   #
########### ####### # ####### #
# #         #         #     # #
# # # ####### ######### ### # #
#   # #   #   #       # # # # #
# ### # ### ### ##### # # # # #
# #   #   # # #     #   # #   #
# # ### # # # ##### ##### #####
# # # # #   #   #   #   #   # #
# # # # ##### # # ### # # # # #
# # #   #     # #   # #   #   #
# # # ### ##### ### # ####### #
# # #   # #   #   #   #     # #
### ### ### # # # ##### ##### #
#   #       #   #       #     #
# ### ################### #####
# #   #       #         # #   #
# ##### ##### # ####### # # # #
#           #         #     #E#
###############################
