###############################
#S  #     #       #           #
### # ##### # ### ##### ##### #
#   #     # #   #       #   # #
# ####### # ### ######### # # #
#       #   # # #   #     #   #
####### # ### # # # # ##### ###
#       #     # # # # #   #   #
# ########### # # # ### # #####
# #       #   # # #     #     #
# # ##### # ### # ########### #
# # #     #   # #   #         #
# # ### ##### # # ### #########
# #   # #   # #   #   #       #
# ### # # # # ##### ### ##### #
# #   # # # #     #         # #
# # ### # ##### ############# #
#   # # # #     #             #
##### # # # ##### ########### #
#   #   # # # #   #           #
### # ### # # # # #############
#   # #   #   # # #       #   #
# ### # ##### # ### ##### # # #
# #   #       #       # #   # #
# # ######### ####### # ##### #
#   #       #   #   #       # #
# ### ##### # ### # ####### # #
# #     # # # #   #   #     # #
# ##### # # ### ##### ####### #
#       #       #            E#
###############################
