+---+---+---+---+---+
| O |               |
+   +---+   +---+   +
|       |   |       |
+---+   +   +---+---+
|   |   |           |
+   +   +---+---+   +
|   |   |       |   |
+   +   +   +   +   +
|           |     T |
+---+---+---+---+---+
