+-+-+-+-+-+-+
|S  |       |
+-+ +-+ +-+ +
| |     |   |
+ +-+-+-+ +-+
|       | | |
+-+ +-+-+ + +
|   |     | |
+ +-+ +-+-+ +
|   | |     |
+ + + + +-+ +
| |     |  E|
+-+-+-+-+-+-+
