+-+-+-+-+-+-+-+-+-+-+-+-+-+-+-+
|S  |             |           |
+-+ + + +-+-+-+-+-+ +-+-+-+-+ +
|   | |         |         | | |
+ +-+ +-+-+-+-+ + +-+-+-+ + + +
|   |     |   |   |   |     | |
+-+ +-+ +-+ + + +-+ + +-+-+-+ +
| | |   |   | | |   | |     | |
+ + +-+-+ +-+ + + +-+ + +-+ + +
| |       | | | | | |   | |   |
+ +-+-+-+-+ + +-+ + +-+-+ +-+ +
| |         | |   |         | |
+ + +-+ +-+-+ + +-+ +-+-+-+ + +
| | | |   |   |   | |   | | | |
+ + + +-+ + +-+ + + + + + + + +
| | |   |   |   | | | |   |   |
+ + + +-+-+-+-+-+ + + +-+ +-+-+
|   |   |       | |   |       |
+ +-+ + + + +-+ + +-+-+-+-+-+ +
|   | |   | |     |     |   | |
+-+ +-+-+-+ +-+-+-+ +-+ + + +-+
|   |     |       | | |   |   |
+ +-+ +-+ +-+-+ + + + +-+-+-+ +
|   | |       | |     |       |
+-+ + +-+-+-+ +-+-+-+ + +-+-+-+
|   |   |   |       | |       |
+ +-+-+ + + +-+-+-+ + +-+-+-+ +
|   |   | | |     | | |       |
+-+ + +-+ +-+ +-+ + +-+ +-+-+ +
|     |         |       |    E|
+-+-+-+-+-+-+-+-+-+-+-+-+-+-+-+
