+-+-+-+-+-+-+-+-+-+-+-+-+-+-+-+
|S  |         |     |         |
+-+ + +-+-+-+ + + +-+ + +-+-+ +
|   | |       | |     |   |   |
+ +-+ + +-+-+-+-+-+ +-+-+ +-+ +
| |   | |         | |   |   | |
+ +-+ + + +-+ +-+ + + +-+-+ + +
|     | |   | |   | |   |   | |
+-+-+-+ +-+-+ + +-+ +-+ + +-+ +
|     |       | |     | |   | |
+ +-+ +-+-+-+-+ +-+-+ + +-+ + +
|   |         |     |     | | |
+-+ +-+-+-+-+ +-+-+ +-+ +-+ + +
| |   |     |   |   | | |   | |
+ +-+ + +-+-+ +-+ +-+ + + +-+ +
|     |     |   |   |   | |   |
+ +-+-+-+-+ +-+ +-+ +-+-+ + +-+
|             |   |     | |   |
+-+-+-+-+-+ +-+-+ +-+-+ + +-+ +
|           |   |   | | |   | |
+ +-+-+-+-+-+ + + + + + +-+ + +
|   |     |   | | |   |     | |
+-+ +-+ +-+ +-+ + +-+ +-+-+-+ +
|   |   |   | |   | |   |     |
+ +-+ +-+ +-+ +-+-+ +-+ + +-+-+
|   |   |   |           |   | |
+-+ +-+ +-+ +-+ +-+-+ +-+-+ + +
|   |   | |   | |   | |   | | |
+ +-+ + + +-+ +-+ + +-+ + + + +
|     |     |     |     |    E|
+-+-+-+-+-+-+-+-+-+-+-+-+-+-+-+
