+-+-+-+-+-+-+
|S        | |
+-+-+-+-+ + +
|   |   | | |
+ +-+ + + + +
| |   | | | |
+ + +-+ + + +
|   | | | | |
+ +-+ + + + +
|     | | | |
+-+-+ + + + +
|     |    E|
+-+-+-+-+-+-+
