+-+-+-+-+-+-+
|S|   |     |
+ + + + + +-+
| | |   |   |
+ +-+-+ +-+ +
|     |   | |
+-+-+ +-+ + +
|   | |   | |
+ +-+ + +-+ +
|     |   | |
+ +-+-+-+-+ +
|          E|
+-+-+-+-+-+-+
