+-+-+-+-+-+-+-+-+-+-+-+-+-+-+-+
|S  |   |       |   |       | |
+-+ + +-+ +-+ + + + +-+-+ + + +
|   |   |   | | | |       |   |
+ +-+-+ + +-+ + + +-+-+-+-+-+ +
| |   |   |   | |   |   |   | |
+ + + +-+-+ +-+ +-+ + +-+ + + +
| | |       |   |   | |   |   |
+ + +-+-+-+-+ +-+ +-+ + +-+-+-+
| | |     |   |   |   |   |   |
+ + + +-+ + +-+ +-+ +-+-+ +-+ +
|   | | |   |   |       |     |
+-+-+ + +-+-+ +-+ +-+ +-+-+-+ +
| |   |       |     |       | |
+ + +-+ +-+-+-+-+-+-+ +-+ + + +
| | |               | | | | | |
+ + + +-+-+-+-+-+-+ + + + + + +
| | |             | |   | | | |
+ + +-+-+-+-+-+ +-+ +-+ + +-+ +
|   |     |   | |   |   |   | |
+ +-+ +-+ + + + + +-+-+-+-+ + +
| |   | | | |   |     |     | |
+ + + + + +-+-+-+ +-+ + +-+-+ +
| | | | |       |   | |       |
+ +-+ + +-+-+-+ +-+-+ + +-+-+-+
|     |       | |   | |   |   |
+-+-+-+ +-+ +-+ + + + +-+ +-+ +
|       |   |   | | | | |   | |
+ +-+ +-+-+-+ +-+ + + + +-+ + +
|   |             |   |      E|
+-+-+-+-+-+-+-+-+-+-+-+-+-+-+-+
