+-+-+-+-+-+-+-+-+-+-+-+-+-+-+-+
|S|     |   |         |       |
+ +-+ + + + + +-+ +-+ +-+-+ + +
|   | | | | |   | |   |   | | |
+-+ +-+ + + +-+ + + +-+ + + +-+
| |   |   |     | |   | | |   |
+ +-+ + +-+-+-+-+ +-+ + + +-+ +
|   | |   |   |   |     |     |
+ +-+ + +-+ + + +-+-+-+-+-+-+ +
|   | | |   | |   |       |   |
+-+ + +-+ +-+ +-+ + +-+-+ + +-+
|   |   |   |   |   |   | | | |
+ +-+-+ + + +-+ +-+-+ + + + + +
|       | | | |       | | | | |
+ +-+-+-+-+ + +-+-+-+-+ + + + +
| |         |         |   |   |
+ + +-+ +-+-+-+ + +-+-+-+-+-+ +
| |   | |       | |           |
+ + +-+ +-+-+ +-+-+ +-+-+-+-+-+
| | |   |     |     |     |   |
+ +-+ +-+ + +-+ +-+-+ +-+-+ + +
|     |   | |   |           | |
+-+-+-+ + +-+ +-+-+-+-+ +-+-+ +
|     | | |   |       | |     |
+-+ + + + + +-+-+ +-+ +-+ +-+ +
|   | | |   |     | |     |   |
+ +-+-+ +-+-+ + +-+ +-+-+-+ +-+
| |   |   |   |   |   |     | |
+ + + +-+ +-+-+-+ + +-+ +-+-+ +
|   |             |          E|
+-+-+-+-+-+-+-+-+-+-+-+-+-+-+-+
