+-+-+-+-+-+-+
|S        | |
+-+-+-+-+ + +
|       | | |
+-+ +-+-+ + +
|   |     | |
+ +-+ +-+-+ +
|   |   |   |
+-+ +-+ + +-+
|     | |   |
+ +-+-+ +-+ +
|          E|
+-+-+-+-+-+-+
