+-+-+-+-+-+-+-+-+-+-+-+-+-+-+-+
|S|           |     |         |
+ +-+ +-+-+-+-+ + +-+ +-+ +-+ +
|   | |   |     |     |   | | |
+-+ + + + + +-+-+-+-+-+ +-+ + +
| | |   |   |         |   | | |
+ + + +-+-+-+ +-+-+-+ + + + + +
|   |     |   |     | | | |   |
+ +-+ +-+-+ +-+-+ + + +-+ +-+ +
|   | |     |     | |   |   | |
+-+ + + +-+-+ +-+-+ +-+ +-+ +-+
|   | | |   |   | |   |   |   |
+ +-+ + + + + + + +-+ +-+ + + +
| |   | | |   | |     |   | | |
+ + +-+ +-+-+ + +-+-+ + +-+-+ +
| |   |     | | |   | |       |
+ +-+ +-+-+ + + + + + +-+-+-+ +
| |   |     | |   | |       | |
+ +-+-+ +-+-+-+ +-+ +-+-+-+ + +
| |   |       |   | |   |   | |
+ + + +-+-+ + +-+-+ + +-+ +-+ +
|   |     | |   |   |       | |
+-+-+-+-+ + +-+ + +-+ +-+-+-+ +
|       | | |   |   | |   |   |
+ +-+-+ + + + +-+-+ + + + + +-+
| |     | | | |     |   | | | |
+ + +-+ + +-+ + +-+-+-+-+ + + +
| | |   |     |     |   | |   |
+ + +-+-+-+-+-+ +-+ + + +-+-+ +
| |               |   |      E|
+-+-+-+-+-+-+-+-+-+-+-+-+-+-+-+
