+-+-+-+-+-+-+-+-+-+-+-+-+-+-+-+
|S  |   |         |           |
+-+ + + +-+-+ +-+ + +-+-+-+ +-+
| |   |     |   |         |   |
+ +-+-+-+-+ + +-+-+-+-+-+-+-+ +
|         | | |         |   | |
+ +-+ +-+ + +-+ +-+-+-+ + + + +
|   | | | |     | |     | |   |
+-+ + + + +-+-+-+ + +-+-+ +-+ +
|   | | | |     |   |     | | |
+ +-+ + + + +-+ + +-+-+ +-+ + +
| |   | | | |   | |     |   | |
+-+ +-+ + + + +-+ + +-+-+ +-+ +
|   |   | | | |   | |   |     |
+ +-+ + + + +-+ +-+ + +-+ +-+-+
|   | |   |   |     |     |   |
+-+ + +-+-+-+ +-+-+-+ +-+-+ + +
|   |       |     |   |   | | |
+ + +-+-+-+ +-+ +-+ +-+ + + + +
| | |   |     | |   |   |   | |
+ +-+ + +-+-+ + + +-+ + +-+-+ +
|     | |   |   |   | | |   | |
+ +-+-+ + + +-+ +-+ +-+ + +-+ +
|     |   |   |   |     |   | |
+-+-+ +-+-+-+ +-+-+-+-+-+-+ + +
|   |     | |               | |
+ + +-+-+ + +-+-+-+-+ +-+-+-+ +
| |     |   |   |   | |   |   |
+ +-+-+-+-+ + + +-+ + + + + +-+
|             |     |   |    E|
+-+-+-+-+-+-+-+-+-+-+-+-+-+-+-+
