+-+-+-+-+-+-+-+-+-+-+-+-+-+-+-+
|S|         |   |     |       |
+ +-+ +-+-+ + + +-+ + +-+-+-+ +
|     | |   | |     |     |   |
+-+-+-+ + +-+ +-+-+-+-+-+ + + +
| |     | |   |   |       | | |
+ + + +-+ + +-+ +-+ +-+-+-+ +-+
|   |   |   |   |   |         |
+ +-+-+ +-+-+ + + +-+-+-+-+-+ +
| |   |     | |   |         | |
+ +-+ +-+-+ + +-+-+ +-+-+-+ + +
|   | |     |   |   |     | | |
+-+ + + +-+-+-+ + +-+ + +-+ + +
|   | |         | |   |   | | |
+ +-+ +-+-+-+-+-+ + +-+-+ + + +
| |     |     |   | |   | | | |
+ + + + +-+ + + + +-+ + + + + +
| | | |   | |   |     | |     |
+ + + +-+ +-+-+-+-+-+-+ +-+-+ +
| | | | |             |     | |
+ +-+ + +-+-+-+-+-+-+ + +-+ +-+
|   | | |         |   |   |   |
+-+ + + + +-+-+-+ + +-+-+ +-+ +
| |   | |   |     |     |   | |
+ +-+-+ + +-+ +-+ +-+-+ +-+ + +
|         |   |   |   | |   | |
+ +-+-+-+-+ +-+ +-+-+ + +-+-+ +
| |   |     |         |   |   |
+ +-+ + +-+-+-+-+-+-+-+-+ + + +
|     |                     |E|
+-+-+-+-+-+-+-+-+-+-+-+-+-+-+-+
