+-+-+-+-+-+-+-+-+-+-+-+-+-+-+-+
|S  |     |       |           |
+-+ + +-+-+ + +-+ +-+-+ +-+-+ +
|   |     | |   |       |   | |
+ +-+-+-+ + +-+ +-+-+-+-+ + + +
|       |   | | |   |     |   |
+-+-+-+ + +-+ + + + + +-+-+ +-+
|       |     | | | | |   |   |
+ +-+-+-+-+-+ + + + +-+ + +-+-+
| |       |   | | |     |     |
+ + +-+-+ + +-+ + +-+-+-+-+-+ +
| | |     |   | |   |         |
+ + +-+ +-+-+ + + +-+ +-+-+-+-+
| |   | |   | |   |   |       |
+ +-+ + + + + +-+-+ +-+ +-+-+ +
| |   | | | |     |         | |
+ + +-+ + +-+-+ +-+-+-+-+-+-+ +
|   | | | |     |             |
+-+-+ + + + +-+-+ +-+-+-+-+-+ +
|   |   | | | |   |           |
+-+ + +-+ + + + + +-+-+-+-+-+-+
|   | |   |   | | |       |   |
+ +-+ + +-+-+ + +-+ +-+-+ + + +
| |   |       |       | |   | |
+ + +-+-+-+-+ +-+-+-+ + +-+-+ +
|   |       |   |   |       | |
+ +-+ +-+-+ + +-+ + +-+-+-+ + +
| |     | | | |   |   |     | |
+ +-+-+ + + +-+ +-+-+ +-+-+-+ +
|       |       |            E|
+-+-+-+-+-+-+-+-+-+-+-+-+-+-+-+
