+-+-+-+-+-+-+
|S        | |
+-+-+-+-+ + +
|     |   | |
+ +-+-+ +-+ +
| |     |   |
+ + +-+-+ + +
| | |     | |
+ + + + +-+ +
| | | | |   |
+ + +-+ + +-+
|       |  E|
+-+-+-+-+-+-+
