+-+-+-+-+-+-+
|S|     |   |
+ + +-+ +-+ +
| | | | |   |
+ + + + + + +
|   |   | | |
+-+-+ +-+ +-+
|   | |     |
+ + + + +-+ +
| |   | |   |
+ +-+-+-+ + +
|         |E|
+-+-+-+-+-+-+
