+-+-+-+-+-+-+
|S    |   | |
+-+-+ + + + +
|   | | |   |
+ +-+ + +-+-+
| |   |     |
+ + +-+ +-+ +
| | |   |   |
+ + +-+-+ + +
| |       | |
+ +-+-+-+-+ +
|          E|
+-+-+-+-+-+-+
