+-+-+-+-+-+-+-+-+-+-+-+-+-+-+-+
|S|         |         |       |
+ + +-+-+ + +-+-+ +-+ +-+-+-+ +
| |   |   | |     | |         |
+ +-+ + +-+ + +-+-+ +-+-+-+-+ +
| | | | | |   |       |     | |
+ + + + + +-+-+ +-+-+ +-+ + + +
| |   | |       |   |     | | |
+ +-+-+ +-+ +-+-+ + +-+-+-+-+ +
|       |   |     |       |   |
+-+-+-+-+ +-+ +-+-+-+-+-+ + +-+
| |         | |   |     | |   |
+ + +-+-+-+ + + +-+ +-+ + +-+ +
| | |   |   |   |   | |     | |
+ + + +-+ +-+-+ + +-+ + +-+-+ +
|   |   |     | |   |   |     |
+ +-+-+ +-+-+ + +-+ +-+-+ +-+-+
|       |   |   |   |   | |   |
+-+-+-+ + + +-+-+ +-+ + + +-+ +
|   |   | |     |     | |     |
+-+ + +-+-+-+-+ +-+-+-+ +-+-+ +
|   | |   |   |       |   |   |
+ +-+ + + + + +-+ + + +-+ + +-+
|   | | |   |   | | |   | | | |
+ + + + +-+-+-+ + + + +-+ + + +
| | |   |     | | | | |   |   |
+ + +-+-+ + +-+ +-+ + + +-+-+ +
| |     | |   |     | |     | |
+ +-+ +-+ +-+ +-+-+-+ +-+ +-+ +
|   |       |           |    E|
+-+-+-+-+-+-+-+-+-+-+-+-+-+-+-+
