+-+-+-+-+-+-+-+-+-+-+-+-+-+-+-+
|S  |   |         |         | |
+-+ + + +-+-+-+ + + +-+-+-+ + +
| |   |     |   | | |         |
+ +-+-+-+-+ + +-+ + +-+-+-+-+-+
|       |   | | | |           |
+-+ +-+ + +-+ + + +-+-+-+-+-+ +
|   |   | |   |   |           |
+ +-+ +-+ + + + +-+ +-+-+-+-+ +
| |     | | | |   |   |       |
+ +-+-+-+ +-+ +-+ +-+ + +-+-+-+
|   |   | |   |       |     | |
+-+ + + + + +-+ +-+-+-+-+-+ + +
|   | |   |   | |       |   | |
+ +-+ +-+-+-+ +-+ +-+-+ + +-+ +
| |   |       |   |   | | |   |
+ + +-+ +-+-+ + +-+ + + + +-+ +
|   |     | | | | | |   |     |
+ +-+-+-+ + + + + + +-+-+-+-+ +
|       | |   | | |     |     |
+-+-+-+ + +-+-+ + +-+-+ +-+-+ +
| |     |   |         |     | |
+ + +-+-+ + + +-+-+-+-+-+-+ + +
| |     | |     |           | |
+ +-+-+ +-+ +-+-+ +-+-+-+-+-+ +
|     |   |   |   |   |     | |
+-+-+ +-+ +-+ + +-+ + + +-+ + +
|       | |   | | | |   | |   |
+ +-+-+-+ +-+-+ + + +-+-+ +-+-+
|               |            E|
+-+-+-+-+-+-+-+-+-+-+-+-+-+-+-+
