+-+-+-+-+-+-+
|S  | |     |
+-+ + + +-+ +
| | |     | |
+ + +-+-+-+ +
|   |     | |
+ +-+ +-+ + +
| |   | |   |
+ +-+ + +-+ +
|     |     |
+-+-+-+ +-+-+
|          E|
+-+-+-+-+-+-+
