+-+-+-+-+-+-+
|S    |     |
+-+-+ +-+-+ +
|   |   |   |
+ +-+-+ + + +
|       | | |
+ +-+-+-+ + +
|     |   | |
+-+-+ +-+ + +
|   |     | |
+ + +-+-+-+ +
| |        E|
+-+-+-+-+-+-+
