+-+-+-+-+-+-+-+-+-+-+-+-+-+-+-+
|S  |   |   |     |           |
+-+ + + + +-+ + +-+ +-+ +-+-+ +
| |   | |     |     |   |   | |
+ +-+-+ + +-+-+-+-+ + +-+ + +-+
| |     | | |     | |     |   |
+ + +-+-+ + + +-+ + +-+-+-+ + +
|   |   |   | | | |   |   | | |
+ +-+ + + +-+ + + +-+-+ + + + +
|   | |   |   | |       | | | |
+-+ +-+-+-+ +-+ +-+-+-+-+ + + +
| |     |   |           | | | |
+ +-+-+ + +-+ +-+ +-+-+ + +-+ +
| |   | | |     |     | |   | |
+ + + + + +-+-+-+-+-+ +-+-+ + +
| | |   |           |     |   |
+ + +-+-+ +-+-+-+-+ + +-+ +-+ +
| |   |     |   |   |   |   | |
+ +-+ +-+-+ + + + +-+-+ +-+ + +
|   |   |   | | | |   | | |   |
+ + +-+ + +-+ +-+ + +-+ + +-+-+
| | |   |     |   |   | |     |
+ + + +-+-+ +-+ +-+-+ + + +-+ +
| | | |   | |   |     |   |   |
+ +-+ + +-+ + +-+-+ + +-+-+ +-+
| |   | |   |   |   | |   | | |
+ + +-+ + +-+-+ + +-+-+ + + + +
| | |     |     |     | | |   |
+ + +-+-+-+ +-+-+ +-+ + + +-+ +
|           |       |   |    E|
+-+-+-+-+-+-+-+-+-+-+-+-+-+-+-+
