+-+-+-+-+-+-+-+-+-+-+-+-+-+-+-+
|S  |           |   |     |   |
+-+ +-+ +-+-+-+ + + + +-+ +-+ +
| |     |   | |   |   | | |   |
+ +-+-+-+ + + +-+-+-+-+ + + + +
|     |   |     |         | | |
+ +-+ + +-+-+-+ + +-+-+-+-+ + +
| | |   |       | | |     | | |
+ + +-+-+ +-+-+-+ + + + + + + +
| |         |   | |   | | | | |
+ +-+-+-+ +-+ + + + +-+ + + +-+
|       | |   | | |   | | |   |
+ +-+-+ + + +-+ + +-+ + + +-+ +
|     | | |   | | |   | |   | |
+-+-+-+ +-+-+ + + +-+ + +-+ + +
|     | |     | |   | |   |   |
+ +-+ + + +-+-+ +-+ + +-+ +-+ +
| |     | |   |   | |   |   | |
+ +-+-+-+ + + +-+ + +-+-+-+ + +
| |     | | | |   | |     | | |
+ + +-+ + +-+ + + + + +-+ + +-+
| | | | | |   | | | | | | |   |
+ + + + + + + + + + + + + + + +
|     | |   | | | |   |   | | |
+ +-+-+ +-+ +-+ + +-+-+ +-+-+ +
| | |   |   |   |   | | |   | |
+ + + +-+ +-+ +-+-+ + + + + + +
| | | |   |   |   |   | | |   |
+ + + + +-+ +-+ + +-+-+ + +-+ +
|   |     |     |         |  E|
+-+-+-+-+-+-+-+-+-+-+-+-+-+-+-+
