+-+-+-+-+-+-+
|S  |   |   |
+-+ + + + + +
|   | |   | |
+ +-+ +-+-+ +
| |   |   | |
+ +-+-+ + + +
|       |   |
+-+-+-+-+-+ +
|         | |
+ +-+-+-+-+ +
|          E|
+-+-+-+-+-+-+
