+-+-+-+-+-+-+
|S  |       |
+-+ +-+-+ +-+
| | |   |   |
+ + + + + + +
| |   | | | |
+ +-+-+ +-+ +
| |   |   | |
+ + + +-+ + +
| | |   |   |
+ + +-+ +-+ +
|     |    E|
+-+-+-+-+-+-+
