+-+-+-+-+-+-+-+-+-+-+-+-+-+-+-+
|S      |   | |               |
+-+-+-+ + + + + +-+-+-+-+-+-+ +
|     |   | | | |       |   | |
+ +-+ +-+-+ + + +-+-+ +-+ + + +
| | |   |   |   |     |   | | |
+ + +-+ + +-+ +-+ + +-+ +-+ + +
|     | | | |     | |   |     |
+-+-+-+ + + +-+-+-+ + +-+-+-+ +
|     | | |       | |       | |
+ +-+ + + + + +-+-+ +-+-+-+ +-+
| |     | | |             |   |
+ +-+-+-+ +-+-+-+-+-+-+-+-+-+ +
|       |             |       |
+ +-+-+ +-+-+-+-+-+-+ + +-+-+ +
| | |   |     |     | |     | |
+ + + + + + +-+ + + + +-+-+ + +
| | | |   | |   | | |     | | |
+ + + +-+-+ + +-+ + +-+-+ + +-+
|   | |   | | | | |     | |   |
+ +-+ + +-+ + + + +-+-+ + + + +
| |   | |   |   |   |   | | | |
+-+ +-+ + +-+-+ +-+ +-+ + + + +
|   |         |   |   | | | | |
+ +-+ +-+-+-+ +-+ +-+ +-+ + + +
| |   |   |     | |   |   | | |
+ + +-+ + +-+ +-+ + +-+ +-+ + +
| | |   |   | |   |     |   | |
+ +-+ +-+-+ +-+ +-+-+-+-+-+-+ +
|         |                  E|
+-+-+-+-+-+-+-+-+-+-+-+-+-+-+-+
