+-+-+-+-+-+-+-+-+-+-+-+-+-+-+-+
|S|       |       |     |     |
+ + + +-+-+ +-+ + +-+ + +-+ + +
| | |     | |   |     |     | |
+ + +-+-+ + + + +-+-+-+-+-+-+ +
| |     |   | | |   |       | |
+ +-+-+ +-+-+ +-+ + +-+-+ +-+ +
|     | |   |     |     |     |
+-+-+ + + +-+-+-+-+-+-+ +-+-+ +
|   | | |       |     |     | |
+ + + + +-+ +-+ + +-+ +-+-+ + +
| | | |     | | | |   |     | |
+-+ + +-+-+-+ + + + +-+ +-+-+ +
|   | | |     | | | |   |   | |
+ +-+ + + +-+ + + + + +-+ +-+ +
|     | | | |   | | | |     | |
+ +-+-+ + + +-+-+-+ + +-+ + + +
|     | |         | |   | |   |
+-+-+ + +-+-+-+-+ + +-+ +-+-+-+
|   | | |         |   |       |
+ +-+ + + +-+-+-+-+ + +-+-+-+ +
|   | |   |         |     |   |
+-+ + + +-+ +-+-+ +-+-+-+ + +-+
|   | |     |   | |     | |   |
+ +-+ +-+-+ + + +-+ +-+ +-+-+ +
|   |     | | |   |   |     | |
+ + +-+-+ + + +-+ +-+ +-+-+ + +
| |     | | | | |   |   | | | |
+ + +-+-+ +-+ + +-+ +-+ + + + +
| |           |         |    E|
+-+-+-+-+-+-+-+-+-+-+-+-+-+-+-+
