+-+-+-+-+-+-+-+-+-+-+-+-+-+-+-+
|S|       |       |     |     |
+ +-+ + +-+ +-+ + +-+ + +-+ + +
| |   | |   | | |     |   | | |
+ + +-+-+ +-+ + +-+-+-+-+ + + +
| | |     |   | |       | | | |
+ + + +-+-+-+ + +-+-+-+ + +-+ +
| |   |       | |     | |   | |
+ +-+ +-+ +-+-+ + +-+ + +-+ + +
|   |   |     | |   |     | | |
+-+ +-+ +-+-+ + + + +-+-+ + + +
| | | | |     | | | |   | | | |
+ + + + + + +-+ + + + + + + + +
| | | |   | |   | |   | | |   |
+ + + + +-+-+ +-+ +-+-+ + +-+ +
|   |   |     | |   |   |   | |
+ +-+-+-+ +-+-+ +-+ + +-+-+-+ +
|   |   | | |   |   | |   |   |
+-+ + + + + + + + +-+ + + + +-+
| | | | | | | |   | |   |   | |
+ + + + + + + +-+-+ +-+-+-+-+ +
| |   | | |   |           |   |
+ +-+-+ + +-+ + +-+-+-+ + +-+ +
|       |   | |     |   |     |
+ +-+-+-+-+ + +-+-+ + +-+-+-+ +
|     |     |   |   | |     | |
+-+-+ +-+ +-+-+ +-+-+ + +-+ + +
|     |   | |   |     | |   | |
+ +-+-+ +-+ + +-+ +-+-+ +-+-+ +
|       |         |          E|
+-+-+-+-+-+-+-+-+-+-+-+-+-+-+-+
