+-+-+-+-+-+-+-+-+-+-+-+-+-+-+-+
|S            |     |   |     |
+-+-+-+-+-+-+ + +-+ +-+ + +-+ +
|     |     | |   |   | |   | |
+ +-+-+ + + + +-+ +-+ + + +-+ +
|   |   | | |     |   | | |   |
+ + + +-+ + +-+-+-+ +-+ + + + +
| |   |   | |     | | |   | | |
+ +-+-+ +-+-+ + +-+ + + +-+ +-+
|   |   |     |     | | | |   |
+-+-+ +-+ +-+-+-+-+-+ + + +-+ +
|     |   | |         |   | | |
+ +-+-+ +-+ + + +-+-+ +-+ + + +
| |   | |     |   |     |   | |
+ + + + +-+-+-+-+ +-+-+-+ +-+ +
|   | |     |   |     |   |   |
+ +-+ +-+-+ + + +-+-+ + +-+ + +
| | |     |   |     |     | | |
+ + +-+-+ +-+-+-+-+ + +-+-+ + +
| |     |         | |   |   | |
+ + +-+ +-+-+-+ +-+ +-+ + +-+-+
| |   | |     |     |   |     |
+ +-+ + +-+-+ +-+-+-+-+-+-+-+ +
|   | |       |       |       |
+-+ + +-+-+-+ + +-+-+ + +-+-+ +
| |   |     | |     |   | |   |
+ +-+-+-+ + + + +-+ +-+-+ + +-+
|         | | | |   |     |   |
+ + +-+-+-+-+ +-+ +-+ +-+-+-+ +
| |               |          E|
+-+-+-+-+-+-+-+-+-+-+-+-+-+-+-+
