+-+-+-+-+-+-+-+-+-+-+-+-+-+-+-+
|S    |           |           |
+-+-+ + +-+ +-+-+-+ + +-+-+-+-+
|   | |   |   |   | | |       |
+ + + +-+-+-+ + + + + + +-+-+ +
| | |   |   |   | | |   | |   |
+ + +-+ + + +-+-+ + +-+-+ + +-+
| |   | | | |   | | |     |   |
+ +-+ + + + + + + + + + +-+-+ +
| | |   | |   |   | | | |     |
+ + +-+-+ +-+-+-+-+ + + + +-+-+
| |   |     |         | | |   |
+ + + +-+-+ + +-+-+-+ +-+ + + +
| | | |   |     |   | |   | | |
+ + + + + +-+-+ + + +-+ +-+ + +
| | |   |     | | |   |     | |
+ + +-+-+-+-+ +-+ +-+ +-+-+ + +
|   |       |   |   |     | | |
+-+-+ + +-+ +-+ +-+ +-+-+ +-+ +
| |   | |     |     |   |   | |
+ + +-+ +-+-+-+-+-+-+-+ +-+ + +
| |   | |     |           |   |
+ + +-+ + +-+ + + +-+ +-+-+-+ +
| | |   |   |   |   | |       |
+ + + +-+-+ +-+-+-+ +-+ +-+-+-+
|   |     |   |   |   |   |   |
+ +-+-+-+ +-+ + +-+-+ +-+ + + +
| |   | |     |     | |   | | |
+ + + + +-+-+-+-+ + + + +-+-+ +
|   |             | |        E|
+-+-+-+-+-+-+-+-+-+-+-+-+-+-+-+
