+-+-+-+-+-+-+-+-+-+-+-+-+-+-+-+
|S|         |   |       |     |
+ + +-+-+ + + + +-+ + +-+ +-+ +
| |   |   | | |   | |       | |
+ +-+-+ +-+ + +-+ +-+-+-+-+ + +
|     |   |   | | |     |   | |
+-+-+ +-+ +-+-+ + + +-+ + +-+ +
|   |     | |   | | |   | |   |
+ +-+-+-+-+ + + + + + +-+ + + +
|       |     | |   | | | | | |
+ +-+ +-+ +-+-+ +-+-+ + + + +-+
| | |         |   | | |   |   |
+ + +-+-+-+-+-+ + + + + +-+-+ +
|   |     |     | | | |     | |
+-+ + +-+ + +-+-+ + + +-+-+-+ +
| | |   | |   |     | |     | |
+ + +-+ + +-+ +-+-+-+ + +-+ + +
| | | | |     |   |   | |   | |
+ + + + +-+-+ + + + +-+ + +-+ +
| | | | |     | |   |   |   | |
+ + + + +-+-+-+ +-+-+ +-+-+ + +
| | | |   |     |     |   |   |
+ + + +-+ + +-+-+-+-+ + + +-+ +
|   |   |   |         | |   | |
+ +-+ +-+-+-+-+ +-+-+-+-+-+ + +
|   |         | |           | |
+-+ +-+ +-+-+ + +-+ +-+-+-+-+ +
| |   | | |   | |   |   |     |
+ +-+ + + + +-+ + +-+ + + +-+-+
|       |       |     |      E|
+-+-+-+-+-+-+-+-+-+-+-+-+-+-+-+
