+-+-+-+-+-+-+
|S  |       |
+-+ + +-+-+-+
|   |   |   |
+ +-+-+ + + +
| |   |   | |
+ + + + +-+ +
|   | | |   |
+-+-+ + + + +
| |   | | | |
+ + +-+-+ + +
|         |E|
+-+-+-+-+-+-+
