+-+-+-+-+-+-+-+-+-+-+-+-+-+-+-+
|S|       |         |     |   |
+ +-+ +-+ + + +-+-+ +-+ + +-+ +
|     | | | | |   |   | |     |
+-+-+-+ + +-+ +-+ +-+ + +-+-+ +
|   |   |   |   |   |   |   | |
+ + + + +-+ +-+ + + +-+-+ +-+ +
| |   |   | |   | |           |
+ +-+-+-+ + + +-+-+-+-+ +-+-+-+
|     |   | | |       |   |   |
+-+-+ + +-+ + + +-+-+ +-+ +-+ +
|   | |     |   | |   |     | |
+ +-+ +-+-+-+ +-+ + +-+-+-+ + +
|     |       |   | |     |   |
+ +-+-+ +-+-+-+-+ + + +-+ +-+ +
| |   | |       | | | | | |   |
+ + +-+ +-+ + + + + + + + + +-+
| |       | | |   | |   | | | |
+ +-+-+-+ +-+ +-+ + +-+ + + + +
|       |   | |   |     | |   |
+-+-+-+ +-+ + + +-+-+-+-+ +-+ +
|     | |   | |   |     | |   |
+ + +-+ + +-+ +-+ + +-+-+ + +-+
| |   | |     |     |     | | |
+ +-+ + + +-+-+-+-+ + +-+-+ + +
|   |   | |       | | |   | | |
+-+ +-+-+ + +-+-+ +-+ + +-+ + +
| | |     | | |   |   |   |   |
+ + +-+-+-+ + + +-+ +-+ + +-+ +
|           |       |   |    E|
+-+-+-+-+-+-+-+-+-+-+-+-+-+-+-+
