+-+-+-+-+-+-+
|S  |     | |
+-+ + +-+ + +
|   |   | | |
+ +-+ + + + +
| |   | |   |
+ +-+-+ +-+ +
|     |   | |
+-+-+ +-+ + +
|   |     | |
+ +-+-+-+-+ +
|          E|
+-+-+-+-+-+-+
