+-+-+-+-+-+-+-+-+-+-+-+-+-+-+-+
|S|           |               |
+ +-+-+ +-+-+ + +-+-+ +-+-+-+ +
|       |     | |   |   |   | |
+-+-+-+-+ +-+-+ +-+ +-+ + + + +
|       |   | |   | |   | | | |
+ + +-+-+-+ + +-+ + + +-+-+ + +
| |     |   |   | | |     |   |
+-+-+-+ + +-+-+ + + +-+-+ +-+-+
|       | |   | | |   | | |   |
+ +-+-+ + + + + + + + + + + + +
| |     | | |   |   |   |   | |
+ +-+-+-+ + + +-+-+-+-+ +-+-+ +
|         | | |     |       | |
+ +-+-+-+-+ +-+ +-+ + +-+-+ + +
|     |   |       |   |   | | |
+-+-+ + + + +-+-+-+-+-+ + +-+ +
|   | | | |   |         |     |
+-+ + + +-+-+ + +-+-+-+-+-+-+ +
|   | |       | |   |     |   |
+ +-+ +-+-+ +-+ + + + + +-+ +-+
|   |     |   | | | | |   |   |
+ + +-+-+ +-+ + +-+ + +-+ +-+ +
| |     | |   |   |     |   | |
+ + +-+ + + +-+-+ +-+-+-+ +-+ +
| |   | | |   | |       |     |
+ +-+ +-+ +-+ + +-+-+-+ + +-+-+
|   |   |   |   |     | | |   |
+-+ +-+ +-+ +-+-+ +-+ + + +-+ +
|     |           |     |    E|
+-+-+-+-+-+-+-+-+-+-+-+-+-+-+-+
