+-+-+-+-+-+-+
|S|       | |
+ + + +-+ + +
| | |   |   |
+ + +-+ +-+ +
| |   | | | |
+ +-+-+ + + +
|     | | | |
+-+-+ + + + +
|   | | | | |
+ + + + + + +
| |     |  E|
+-+-+-+-+-+-+
