+-+-+-+-+-+-+
|S|         |
+ +-+ +-+-+ +
|   |   |   |
+-+ +-+-+ + +
| |     | | |
+ +-+-+ + + +
|     | | | |
+ +-+ + + +-+
| | |   |   |
+ + +-+-+-+ +
|          E|
+-+-+-+-+-+-+
