+-+-+-+-+-+-+
|S|   |     |
+ + + +-+ + +
|   | |   | |
+-+-+ + +-+ +
|   | | |   |
+ +-+ + + +-+
|   |   | | |
+ + +-+-+ + +
| | |     | |
+ + + +-+-+ +
| |        E|
+-+-+-+-+-+-+
