+-+-+-+-+-+-+
|S        | |
+-+-+-+-+ + +
|     |   | |
+ +-+ + +-+ +
|   |   |   |
+-+ +-+-+-+ +
| |   |   | |
+ +-+ + + + +
|     | | | |
+ +-+-+ + + +
|       |  E|
+-+-+-+-+-+-+
