+-+-+-+-+-+-+
|S  |       |
+-+ +-+ +-+ +
| |     |   |
+ +-+-+-+ +-+
|       |   |
+ +-+ +-+-+ +
| | |     | |
+ + +-+-+ + +
| |   | |   |
+ + + + +-+-+
|   |      E|
+-+-+-+-+-+-+
