+-+-+-+-+-+-+-+-+-+-+-+-+-+-+-+
|S|       |   |             | |
+ +-+-+-+ + + + +-+-+-+ +-+ + +
| |   |   | |   |   |   | |   |
+ + + + +-+ +-+-+ + + +-+ +-+ +
| | | |           | | |   |   |
+ + + +-+-+-+-+-+-+ + + + + +-+
|   |             | | | |   | |
+-+-+-+-+-+-+-+-+ + + +-+ +-+ +
|       |   |     | |   |     |
+ +-+-+ + + + +-+-+-+-+ +-+-+ +
| |   |   | |     |     |   | |
+ +-+ +-+-+ +-+-+ + +-+ + + + +
|       | |   |   | |   | | | |
+-+-+-+ + +-+ + +-+ + +-+ + + +
|   |   |   | | |   | |   | | |
+ +-+ +-+ + + + + + +-+ +-+ +-+
|   |     | |   | |       |   |
+ + +-+-+-+ +-+-+-+-+ +-+-+-+ +
| |       |         | |       |
+ +-+ +-+ +-+-+-+-+ +-+ +-+-+ +
|   |   |         |   |   |   |
+-+ +-+ + +-+-+-+ +-+ + + + +-+
|     | | |     |   | | | |   |
+ +-+-+ + + +-+ +-+ + +-+ +-+-+
| |     | | | |   | |   |     |
+ + +-+-+-+ + +-+ +-+-+ +-+-+ +
| | |   |   |   |     |   |   |
+ + + + + +-+ + +-+ +-+-+ + + +
| |   |       |   |         |E|
+-+-+-+-+-+-+-+-+-+-+-+-+-+-+-+
