+-+-+-+-+-+-+-+-+-+-+-+-+-+-+-+
|S|       |       |   |       |
+ +-+ +-+-+ + +-+ + + +-+-+-+ +
| |   |     |   |   |     |   |
+ + +-+ +-+-+-+ +-+-+-+-+ + +-+
| | |   | |   | |       | |   |
+ + + +-+ + + + + +-+ +-+ +-+ +
| |     |   | | |   |         |
+ +-+-+ +-+-+ + +-+-+-+-+-+-+ +
| |   |     | |       |   |   |
+ + + +-+-+ + +-+-+-+ + + +-+ +
|   | |   | |   |   | | |   | |
+-+-+ + + + + + + + + + +-+ + +
|   |   | |   |   | |     | | |
+ + +-+-+ +-+-+-+-+-+-+-+-+ + +
| |     |   |         |     | |
+ +-+ + +-+ + +-+-+-+ + +-+-+ +
| | | | |   |       |   | |   |
+ + + +-+ +-+-+-+-+ +-+-+ + +-+
|   |   |       |   |         |
+-+ +-+ +-+-+-+ + +-+-+-+-+-+-+
| |   |     |   |     |       |
+ +-+ +-+-+ + +-+ +-+ + +-+-+ +
|   |   | |   |     |       | |
+ + +-+ + +-+-+-+-+-+ +-+-+-+ +
| |   | |           | |       |
+ +-+-+ + + +-+-+-+ +-+ +-+-+ +
| |   | | |   |   |     | |   |
+ + + + +-+-+ + + +-+-+-+ + +-+
|   |         | |            E|
+-+-+-+-+-+-+-+-+-+-+-+-+-+-+-+
