+-+-+-+-+-+-+
|S|         |
+ +-+ +-+-+ +
|   | | |   |
+-+ + + + +-+
| | | | |   |
+ + + + +-+ +
| | | |   | |
+ + + + +-+ +
| |   |     |
+ +-+-+ +-+-+
|          E|
+-+-+-+-+-+-+
