+-+-+-+-+-+-+-+-+-+-+-+-+-+-+-+
|S| |           |             |
+ + + +-+ +-+ +-+ +-+-+-+-+ + +
| |     | |   |   |   |   | | |
+ +-+ +-+ +-+-+ +-+ + + + + + +
|   | |   |         | | | | | |
+-+ + + +-+ +-+-+-+-+-+ + + + +
|   | | |     |     |   |   | |
+ +-+ + + +-+-+ +-+ + +-+-+-+ +
| |   |   |     | | |   |   | |
+ +-+ +-+-+ +-+-+ + + + + + + +
|   |     |   |     | | | | | |
+-+ +-+-+-+ + + +-+-+-+ + + + +
|   |     | | | |       | | | |
+ +-+ +-+ + + + +-+ +-+-+ + +-+
| |   |   | | |   |   |   |   |
+ + +-+ +-+ + +-+ +-+ + +-+-+ +
| |   |   | | | |   |       | |
+ +-+ +-+ + + + +-+ + +-+-+-+ +
|   |   | | | |     | |       |
+-+ + + + + + + +-+-+-+ +-+-+ +
|   | | | | | | |   |   |   | |
+ +-+-+ + +-+ + + + + +-+ + + +
|   |   | |   |   |   |   | | |
+-+ + +-+ + +-+-+-+-+-+ +-+-+ +
| | |   |   |         |     | |
+ + +-+ +-+-+ +-+ +-+ + +-+ + +
| |     |   | | |   | | |   | |
+ +-+-+-+ +-+ + +-+ +-+ + +-+ +
|                 |     |    E|
+-+-+-+-+-+-+-+-+-+-+-+-+-+-+-+
