+-+-+-+-+-+-+
|S  | |     |
+-+ + + + + +
|   |   | | |
+ +-+-+-+ + +
|         | |
+-+-+-+-+-+ +
|     |     |
+ + + + +-+-+
| | | |   | |
+ + +-+-+ + +
| |        E|
+-+-+-+-+-+-+
