+-+-+-+-+-+-+-+-+-+-+-+-+-+-+-+
|S|   |         |   |   | |   |
+ + + + +-+-+-+ + + + + + + + +
|   | |     | |   |   | |   | |
+-+-+ +-+-+ + +-+-+-+-+ + +-+ +
|   |   |   | |       | | | | |
+-+ +-+ + +-+ + +-+ +-+ + + + +
|   | | | |     | |     |   | |
+ + + + + + +-+-+ +-+-+-+-+-+ +
| |   |   | |   |             |
+ +-+-+-+-+ + + +-+ + +-+-+-+ +
| |       |   |   | | |     | |
+ + +-+ + +-+-+-+ +-+ + + +-+ +
| | |   |       |     | |   | |
+ + + +-+-+-+-+-+-+-+-+ +-+ + +
|   | |       |       |   | | |
+ +-+ + +-+-+ + + +-+ +-+ + + +
| |   | |   |   | |     | |   |
+-+ + + +-+ +-+-+ + +-+-+ +-+-+
|   | |     | |   |   |   |   |
+ + +-+-+-+ + + +-+-+ + +-+ +-+
| | |   |   | | |   | |   |   |
+ +-+ + + +-+ + + + + +-+ +-+ +
|     |   |   | | |   |   |   |
+ +-+-+-+-+ + + +-+-+-+ +-+ + +
| |     |   | |         |   | |
+ + +-+ + +-+-+-+-+-+-+-+ +-+-+
| | |   |               |     |
+ + + +-+-+-+-+-+-+ +-+ +-+-+ +
|   |               |        E|
+-+-+-+-+-+-+-+-+-+-+-+-+-+-+-+
