+-+-+-+-+-+-+-+-+-+-+-+-+-+-+-+
|S|     |           |         |
+ + +-+ + + +-+-+-+ + +-+-+-+ +
| |   |   |   |     | |   |   |
+ +-+-+-+-+ + + +-+-+ + + +-+ +
|   |     | | | |   |   |   | |
+-+ + +-+ +-+ + + + +-+ +-+ + +
|   | | |     |   |   | |   | |
+ +-+ + +-+-+-+-+-+-+ + + +-+ +
|     |       |   |   | | |   |
+-+-+-+-+ +-+ +-+ + +-+ + + +-+
|     |   | |     |   | | |   |
+ +-+ + +-+ +-+ +-+-+ +-+ +-+ +
|   |   |     | |   |   | |   |
+ + +-+-+ +-+ + + + +-+ + + +-+
| | |   |   |   | | |   | |   |
+ + + + + +-+-+-+ + + +-+ +-+ +
| | | |   |       |   |     | |
+ + + +-+-+ +-+-+-+-+-+-+-+ + +
| | |   |   |     |   |     | |
+-+ +-+ + +-+ +-+ + + + +-+-+ +
|   |   |   |   |   |   |   | |
+ +-+-+-+-+ + + +-+-+-+-+ +-+ +
|     |     | | |   |     |   |
+-+-+ + +-+-+ + +-+ + + +-+ +-+
|     |     | | |   | |   | | |
+ +-+-+-+-+ +-+ + +-+ +-+ + + +
| |       |     | |   | | |   |
+ + +-+ +-+-+-+-+ + +-+ + +-+ +
|     |                 |    E|
+-+-+-+-+-+-+-+-+-+-+-+-+-+-+-+
