+-+-+-+-+-+-+-+-+-+-+-+-+-+-+-+
|S  |     |   | |       |     |
+-+ + +-+ + + + + + +-+-+ + + +
| |   | |   | | | |       | | |
+ +-+-+ +-+-+ + + +-+-+-+-+ +-+
| |       |   | | |       |   |
+ + +-+-+ + +-+ + +-+-+-+ +-+ +
|   |   | | |   |           | |
+ +-+ +-+ + + +-+-+-+-+ +-+-+ +
| |   |   | |       |   |   | |
+ + + + + + +-+-+-+ + +-+ + + +
| | | | | | |     |   |   |   |
+ +-+ + +-+ + +-+ + +-+ +-+-+-+
| |   |   |   | | | | |       |
+ + + +-+ +-+-+ + + + +-+-+-+ +
| | |   |     |   | |   |   | |
+ + +-+-+-+ +-+ +-+ + + + +-+ +
| |       |     | | | |   |   |
+ +-+ + +-+-+-+-+ + + +-+ + +-+
|   | |       |   |   |   |   |
+-+ +-+-+ +-+ + +-+-+-+ +-+-+ +
| | |   | | | | |           | |
+ + + + + + + + + +-+-+-+ +-+ +
| |   | | | | |   | |   | |   |
+ +-+-+ + + + + +-+ + + +-+ + +
| |     | | | |     | | |   | |
+ + +-+-+ + + +-+-+ + + + +-+ +
| |       | |     | | |   | | |
+ +-+-+-+-+ +-+-+ +-+ +-+-+ + +
|                     |      E|
+-+-+-+-+-+-+-+-+-+-+-+-+-+-+-+
