+-+-+-+-+-+-+
|S|     |   |
+ +-+ + +-+ +
|     |   | |
+-+-+-+-+ + +
| |     | | |
+ + +-+ + + +
| | | | | | |
+ + + + + + +
| |   |   | |
+ +-+ +-+-+ +
|          E|
+-+-+-+-+-+-+
