+-+-+-+-+-+-+
|S  |     | |
+-+ +-+ + + +
| |     | | |
+ +-+-+-+ + +
|       | | |
+ +-+-+ + + +
|   | |   | |
+-+ + +-+-+ +
| | |     | |
+ + + +-+ + +
|     |    E|
+-+-+-+-+-+-+
