+-+-+-+-+-+-+
|S|     |   |
+ +-+ + + + +
|     | | | |
+-+-+-+ +-+ +
| |   | |   |
+ + + + + +-+
|   |   |   |
+ +-+-+-+-+ +
| |         |
+ +-+ +-+-+ +
|     |    E|
+-+-+-+-+-+-+
