+-+-+-+-+-+-+-+-+-+-+-+-+-+-+-+
|S|             |     |       |
+ +-+-+ +-+-+ + + +-+ +-+-+ + +
| |   | |     |   | |     | | |
+ + + +-+ +-+-+-+-+ +-+-+ +-+ +
| | |     |     |       |   | |
+ + +-+-+-+ +-+ + +-+-+ +-+ + +
| |   |   | | |   |   |   | | |
+ + + +-+ + + +-+-+ + + + + + +
| | |   |           | | | | | |
+ +-+-+ + +-+-+-+-+-+-+ + + + +
|       | |         |   | |   |
+-+-+-+-+-+ +-+-+-+ + +-+-+-+ +
| |         |         |     | |
+ + + +-+-+-+ +-+-+-+-+ +-+ + +
|   | |   |   |       | | | | |
+ +-+ + +-+ +-+ +-+-+ + + + + +
| |   |   | | |     |   | |   |
+ + +-+ + + + +-+-+ +-+-+ +-+-+
| | | | |   |   |   |   |   | |
+ + + + +-+-+ + + +-+ + + + + +
| | |   |     | |   | |   |   |
+ + + +-+ +-+-+ +-+ + +-+-+-+ +
| | |   | |   |   |   |     | |
+-+ +-+ +-+ + + + +-+-+ +-+-+ +
|   |       |   |       |     |
+ +-+ +-+-+-+-+-+-+-+-+-+ +-+-+
| |   |       |         | |   |
+ +-+-+ +-+-+ + +-+-+-+ + + + +
|           |         |     |E|
+-+-+-+-+-+-+-+-+-+-+-+-+-+-+-+
