+-+-+-+-+-+-+-+-+-+-+-+-+-+-+-+
|S      |   |                 |
+-+-+-+ + + +-+-+-+ +-+-+ +-+ +
| |   |   |       | |   | | | |
+ + + +-+-+-+-+-+ + +-+ + + + +
|   |       |     |     | | | |
+ +-+-+-+ +-+ +-+-+-+-+-+ + + +
|   |   |     |           | | |
+-+ + +-+-+-+-+ + +-+-+-+-+ + +
| | |         | | |     |   | |
+ + + + +-+-+ +-+ + +-+ + +-+ +
| | | | |   |     |   | |   | |
+ + +-+ + + +-+-+-+-+ + + + + +
| | |   | |           | | | | |
+ + + +-+ +-+-+ + +-+-+ +-+ + +
| | | |     |   | |   |     | |
+ + + +-+-+ + +-+-+ + +-+-+-+ +
|   |     | |       | |       |
+ +-+-+ + +-+ +-+-+-+ + +-+-+-+
|     | |   | |     |   |     |
+-+-+ +-+-+ + + + + +-+-+-+ + +
|   |       | | | | |       | |
+ + +-+-+-+-+ +-+ + +-+ +-+-+ +
| |     |     |   |     |   | |
+ +-+-+ + +-+-+ +-+-+-+-+ +-+ +
| |     |   |   |         |   |
+ +-+-+-+-+ + + + +-+ +-+ + +-+
|   |       | | |   |   | | | |
+ + + +-+-+-+-+ +-+ +-+ +-+ + +
| |             |     |      E|
+-+-+-+-+-+-+-+-+-+-+-+-+-+-+-+
