+-+-+-+-+-+-+-+-+-+-+-+-+-+-+-+
|S|             |       |     |
+ + +-+-+-+-+-+ +-+ +-+ +-+-+ +
| |   |       | |   | | |   | |
+ + + +-+-+ +-+ + +-+ + + + + +
| | |     |   | |   | |   |   |
+ +-+-+-+ + + + +-+ + +-+-+-+ +
|     |   | | |     | |       |
+-+-+ + +-+-+ +-+-+-+ + +-+-+-+
|   |   |         |   | |     |
+ + +-+-+ +-+-+-+ + + + +-+-+ +
| |       |       | | | |   | |
+ +-+-+ +-+-+-+ +-+ + + + + + +
|     |       | | | |   | | | |
+-+-+ +-+-+-+ + + + +-+-+ + + +
|   |       | |   |       | | |
+ +-+-+ +-+-+ +-+ +-+-+-+-+ + +
|       |     |           |   |
+ +-+-+-+ +-+-+-+-+-+ +-+-+-+ +
| |   |   |       |   |     | |
+ + + + +-+ +-+-+ +-+ + + +-+ +
| | | |     |   |   | | |     |
+ + + +-+-+-+ +-+-+ +-+ +-+-+-+
|   | |   |   |     |   |     |
+-+-+ + + + + + +-+ + +-+ +-+ +
|   |   |   | |   | |   |   | |
+ + +-+-+-+ +-+-+ + +-+ +-+-+ +
| |   |   | |     |   | |     |
+ +-+-+ + + + +-+-+-+-+ + +-+ +
|       |   |             |  E|
+-+-+-+-+-+-+-+-+-+-+-+-+-+-+-+
