+-+-+-+-+-+-+
|S      |   |
+-+-+-+ + + +
|     |   | |
+ + +-+-+-+ +
| |       | |
+ +-+-+-+ + +
|     |   | |
+-+-+ + +-+ +
| |   |   | |
+ + +-+-+ + +
|       |  E|
+-+-+-+-+-+-+
