+-+-+-+-+-+-+
|S|   |     |
+ + + +-+-+ +
| | |   |   |
+ + +-+ + +-+
|   | | |   |
+-+-+ + +-+ +
|     |   | |
+ +-+ +-+ + +
|   |   | | |
+ + +-+-+ + +
| |        E|
+-+-+-+-+-+-+
