+-+-+-+-+-+-+
|S|         |
+ + + +-+-+ +
| | |     | |
+ +-+-+-+ +-+
|       |   |
+-+-+-+ +-+ +
| |   |   | |
+ + + +-+ + +
|   |   | | |
+ +-+-+ + + +
|     |    E|
+-+-+-+-+-+-+
