+-+-+-+-+-+-+-+-+-+-+-+-+-+-+-+
|S|           |         |     |
+ +-+ +-+-+ + + +-+-+ +-+ +-+ +
|   | |   | | |     |     |   |
+-+ + +-+ + + +-+-+-+ +-+-+ + +
|   |   | | |       | |   | | |
+ +-+-+ + + +-+-+-+ + + +-+ + +
| |       |   |   | |   |   | |
+ + +-+-+-+-+ + + + +-+ + +-+-+
| |     |     | |   |   |     |
+ +-+-+-+ +-+-+ +-+-+ +-+-+-+ +
|       |     |   |   |     | |
+-+-+-+ + +-+ +-+ +-+ + +-+-+ +
|     | | |   | |   |   |     |
+ +-+ + +-+ +-+ +-+ +-+ + +-+ +
|   | |     | |     |   | |   |
+-+ + +-+-+-+ + +-+-+-+-+ +-+ +
|   |         | |       |   | |
+ +-+-+-+ + +-+ +-+-+ + +-+ + +
| |   | | | |   |     |     | |
+ + + + + +-+ +-+ +-+-+-+-+-+ +
| | |   |   | |   |     |     |
+ + +-+ +-+ + +-+ + +-+ + +-+-+
| |   | |   |   | | |   |     |
+ +-+ + + +-+-+ + + + +-+-+-+ +
|   | | |       | | |   |   | |
+-+ + + +-+-+-+-+ + +-+ + + + +
|   | |     |     |   |   | | |
+ +-+ +-+-+ +-+-+ + + +-+-+-+ +
|     |           | |        E|
+-+-+-+-+-+-+-+-+-+-+-+-+-+-+-+
