+-+-+-+-+-+-+
|S|         |
+ +-+-+ + + +
|     | | | |
+-+-+ + + +-+
| |   | |   |
+ + +-+ +-+ +
| | |     | |
+ + +-+-+ + +
| |   |   | |
+ +-+ +-+-+ +
|          E|
+-+-+-+-+-+-+
