+-+-+-+-+-+-+
|S|     |   |
+ +-+ + +-+ +
|     |     |
+-+-+-+-+-+ +
|         | |
+ +-+ +-+-+ +
| |   |     |
+ +-+-+ +-+-+
|       |   |
+ +-+-+-+ + +
|         |E|
+-+-+-+-+-+-+
