+-+-+-+-+-+-+-+-+-+-+-+-+-+-+-+
|S    |         |             |
+-+-+ + +-+ +-+ +-+-+-+-+ + +-+
|     |   | |           | |   |
+ +-+-+-+ + +-+-+-+-+-+ + +-+ +
|     |   |   |       | | |   |
+-+-+ +-+-+-+ + +-+-+ + +-+ + +
|   |     |   |     | | |   | |
+ +-+-+-+ + +-+-+-+ + + + +-+ +
|     |   | |       | | | |   |
+-+-+ + +-+ + +-+-+-+ + + +-+-+
|     |   | | | |     | |     |
+ +-+-+-+ + + + + +-+-+ + +-+ +
| |       | | | |     | |   | |
+ + +-+-+-+ + + +-+-+ + +-+-+ +
| | |   |   |   |   |     |   |
+ + + + + +-+-+-+ + +-+-+ + + +
| |   | |   |     |     |   | |
+ +-+-+ + + + +-+-+-+-+ +-+-+ +
|   |   | |   |     |   |   | |
+ + + +-+ +-+-+ +-+ + +-+-+ + +
| |   | | |   | | | | |     | |
+ +-+-+ + + + + + + + + +-+-+ +
|     |     | | |   | |     | |
+-+-+ +-+-+-+-+ + +-+ +-+-+ + +
|   |           |   |     |   |
+ + +-+-+-+-+-+-+-+ +-+-+ + +-+
| |   |   |       |   |   |   |
+ +-+-+ + + + +-+-+-+ + +-+-+ +
|       |   |           |    E|
+-+-+-+-+-+-+-+-+-+-+-+-+-+-+-+
