+-+-+-+-+-+-+-+-+-+-+-+-+-+-+-+
|S              |         |   |
+-+-+-+-+-+-+-+ + + +-+ +-+ + +
| |         | | | | |   |   | |
+ + +-+-+ + + + +-+ +-+-+ +-+ +
| | |     | | |   |       |   |
+ + + +-+-+ + +-+ + +-+-+-+ + +
| | | |   |   |   | |     | | |
+ + + + + +-+-+ +-+ + +-+ + +-+
|   | | |   |   |   | |   |   |
+ +-+ + +-+ + +-+ +-+ + +-+-+ +
| |   | | |   |       |     | |
+-+ +-+ + +-+-+-+-+-+-+-+-+ + +
|   |   |           |     | | |
+ + + +-+-+ +-+-+-+ +-+ +-+ + +
| | | |   |   |     |   |   | |
+ +-+ + + +-+ + +-+-+ +-+ +-+ +
|   |   | |   | |         |   |
+-+ +-+-+ + +-+ +-+-+-+-+ + + +
|       |   | | |   |   | | | |
+ +-+-+-+-+-+ + + + + + +-+ + +
|             |   | | |     | |
+ +-+-+-+-+-+ +-+-+ + +-+-+-+ +
| |   |       |   | |   |   | |
+ +-+ + + +-+-+ + + + + + +-+ +
| |   | | |     |   | | | |   |
+ + + + +-+ +-+-+-+-+-+ + + +-+
|   | |   | |       |   |   | |
+-+-+ +-+ + + +-+-+ + +-+ +-+ +
|       |     |       |      E|
+-+-+-+-+-+-+-+-+-+-+-+-+-+-+-+
