+-+-+-+-+-+-+
|S  |       |
+-+ + +-+-+ +
| |   |     |
+ +-+-+ +-+-+
|     |   | |
+ +-+ +-+ + +
|   |     | |
+-+ +-+-+-+ +
|   |     | |
+ +-+-+ + + +
|       |  E|
+-+-+-+-+-+-+
