+-+-+-+-+-+-+
|S|         |
+ + +-+-+ + +
| | |   | | |
+ +-+ + + + +
| |   | | | |
+ + +-+ + +-+
|   | | |   |
+-+-+ + + + +
|   |   | | |
+ + + +-+-+ +
| |        E|
+-+-+-+-+-+-+
