+-+-+-+-+-+-+
|S|         |
+ +-+-+ + +-+
| |   | |   |
+ + + + +-+ +
|   | | | | |
+-+-+ + + + +
|   | |   | |
+ + + +-+ + +
| |   |   | |
+ +-+-+-+-+ +
|          E|
+-+-+-+-+-+-+
