+-+-+-+-+-+-+-+-+-+-+-+-+-+-+-+
|S|               |         | |
+ +-+-+-+-+-+ +-+ + +-+-+-+ + +
|     |     | |   | |         |
+-+-+ + +-+ + + +-+ + +-+-+-+-+
|   |   | | | |     |   |     |
+ +-+-+-+ + + +-+-+-+-+ + +-+ +
| |   |     |     |   | |   | |
+ + + + +-+-+ +-+ + + + +-+ + +
|   | | | |   | |   | |   | | |
+ +-+ + + + +-+ +-+-+ +-+-+ + +
|   | | |           |       | |
+ +-+ + +-+-+-+-+-+ +-+-+-+-+ +
| |   |     |   |     |       |
+ + +-+-+-+ + + +-+-+-+ +-+-+ +
| |         | | |     |   | | |
+ +-+-+-+-+-+ + + +-+ +-+ + + +
| |   | |     |   |   |   |   |
+ + + + + + +-+-+-+-+ + +-+ +-+
|   | |   |         | | |   | |
+-+-+ + +-+-+-+-+-+ + + + +-+ +
|     | |           | | |   | |
+ +-+-+-+ +-+-+-+-+-+ + +-+ + +
| |       |   |       |   |   |
+ + +-+ +-+ + + +-+-+-+-+ +-+ +
| | |   |   | | |         | | |
+ +-+ +-+ +-+-+ + +-+-+-+-+ + +
|     |     |   |   |       | |
+-+-+-+ +-+ + +-+-+ + + +-+-+ +
|         |         | |      E|
+-+-+-+-+-+-+-+-+-+-+-+-+-+-+-+
