+-+-+-+-+-+-+-+-+-+-+-+-+-+-+-+
|S|         |   |   |     |   |
+ + +-+ +-+ + + +-+ + + + + +-+
| |   | |   | |     | | | |   |
+ +-+-+ +-+ + +-+-+-+ + + + + +
|     |   | |   |     | | | | |
+-+-+ + + + + + + +-+-+ + + + +
|     | | | | |       | | | | |
+ +-+-+ + + +-+-+-+ +-+ + +-+ +
|   |   | | |     | |   |   | |
+-+ + +-+ + + +-+ +-+ +-+-+ + +
| | | |   |   |   |   |   |   |
+ + + + +-+-+-+ +-+ +-+ + +-+ +
| | | |   |   | |   | | |   | |
+ + +-+ + +-+ + + +-+ + +-+ + +
| |   | |   | | |   | |   |   |
+ +-+ + +-+ + + +-+ + +-+ +-+-+
|   | |   | | |     | |   |   |
+ + + +-+ + + +-+-+-+ + +-+ +-+
| |   |   | |       |   |     |
+ +-+-+ +-+ +-+-+ + + +-+-+-+ +
| |   |   |     | | | |   |   |
+ + + +-+-+-+-+ + +-+ + + + + +
| | |         | |       | | | |
+ + +-+-+-+-+ + +-+-+-+-+ + +-+
| | | |       | |       | |   |
+ + + + +-+-+-+ + +-+-+ + +-+ +
|   |   |           |   |     |
+-+-+ +-+-+-+-+-+-+-+ +-+-+-+ +
|                     |      E|
+-+-+-+-+-+-+-+-+-+-+-+-+-+-+-+
