+-+-+-+-+-+-+-+-+-+-+-+-+-+-+-+
|S|       |       |           |
+ +-+ +-+ + +-+ + +-+-+ +-+-+ +
|   |   |   |   |   |   | |   |
+-+ +-+ +-+-+ +-+-+ + +-+ + +-+
| |   |   |   |   | | |   | | |
+ +-+ +-+-+ +-+ + + + + +-+ + +
|   |       |   | |   |     | |
+ + +-+-+-+-+ +-+ +-+-+ +-+-+ +
| |   |       | |   | | |     |
+-+ + +-+ +-+ + +-+ + + + + + +
|   |   | |   |   | | | | | | |
+ +-+-+ +-+ +-+ + + + + +-+ + +
| |   |     |   | | | |     | |
+ + +-+-+-+-+ + + + + +-+-+-+ +
| |         | | | | | |       |
+ + +-+ +-+ +-+ +-+ + + +-+-+-+
| |   | |   |   |   | | |     |
+ +-+-+ + +-+ + + +-+ + + +-+ +
|     | |     | |   | | | |   |
+-+-+ + +-+-+-+ +-+ + + + + +-+
|     |     |   |     | | |   |
+ +-+ +-+-+ +-+-+ +-+-+ + +-+ +
| |   |   | |   | |   |   |   |
+ + +-+ + + + + + + + +-+-+ +-+
| | |   | |   |   | |     |   |
+ + + +-+ +-+-+-+-+ + +-+-+-+ +
| | |   |   |     | |       | |
+ +-+-+ +-+ + +-+ + +-+-+ +-+ +
|         |     |       |    E|
+-+-+-+-+-+-+-+-+-+-+-+-+-+-+-+
