+-+-+-+-+-+-+-+-+-+-+-+-+-+-+-+
|S  |   |       |         |   |
+-+ + + + +-+-+ +-+ +-+-+ +-+ +
| |   | |     |     |         |
+ +-+-+ + +-+ +-+-+-+-+-+-+-+ +
|     | | | |             | | |
+ +-+-+ + + +-+-+-+-+-+-+ + + +
| |     | |   |   |   |   |   |
+ + +-+-+ + + + +-+ + + +-+ +-+
| |   | | | |   |   |   |     |
+ +-+ + + + +-+ + +-+-+-+-+-+-+
|   | |     |   |             |
+ +-+ +-+-+-+ +-+-+-+-+ +-+-+ +
|   |       | |       |     | |
+ + +-+-+-+ +-+ +-+-+ +-+-+ + +
| | |     |   |   | | |   | | |
+ + + +-+ +-+ +-+ + + + + + + +
| | |   |   |   | |     | | | |
+ + +-+ +-+ +-+ + +-+-+-+ + + +
| |     | |   | |     | | | | |
+ +-+-+-+ +-+ + +-+-+ + + +-+ +
| |   |   |   |   |   | |     |
+ + + +-+ + +-+-+ + +-+ +-+-+ +
| | |   | |     |   |     |   |
+ + +-+ + +-+-+ +-+-+ +-+ + +-+
| |   | |     |     |   | |   |
+ +-+ + + +-+ +-+-+ + + + +-+ +
|     |   | | |   |   | | |   |
+-+-+-+-+-+ + +-+ +-+-+ +-+ +-+
|                     |      E|
+-+-+-+-+-+-+-+-+-+-+-+-+-+-+-+
