+-+-+-+-+-+-+-+-+-+-+-+-+-+-+-+
|S  |             |     |     |
+-+ +-+-+ +-+-+-+ + +-+ + + + +
| |     |     | | |   | | | | |
+ +-+-+ +-+-+ + + +-+ + + + + +
|     | |   |   |   | |   | | |
+-+ + + + + +-+ +-+ + +-+-+ + +
|   | | | |   |   | | |     | |
+ +-+-+ + + + +-+ + + + +-+-+ +
| |     | | | |   |   |     | |
+ + +-+-+ + +-+ +-+-+-+-+-+ + +
|   |     |             |   | |
+ +-+-+-+ +-+-+-+-+-+ +-+ +-+ +
|   |   |     |     | |   |   |
+-+ + + +-+-+-+ +-+ +-+ +-+ +-+
| |   |         | |   | |   | |
+ +-+-+-+-+-+-+-+ +-+ + + +-+ +
|       | |         | | | |   |
+ +-+-+ + + +-+ +-+ + + + +-+ +
|   | | |     | |   | | |     |
+-+ + + +-+-+-+ +-+-+ + +-+-+-+
|   |     |     |     |       |
+ +-+-+-+ + +-+ + +-+-+ +-+-+ +
| |     |   |   | |       |   |
+ + +-+ +-+-+-+-+ +-+ +-+-+ +-+
| | |   |   |   |   | |   |   |
+ + + +-+ + + + +-+ +-+ + +-+ +
|   | |   |   |   |   | |     |
+ +-+ + +-+-+-+-+ +-+ + +-+-+ +
|   |           |       |    E|
+-+-+-+-+-+-+-+-+-+-+-+-+-+-+-+
