+-+-+-+-+-+-+-+-+-+-+-+-+-+-+-+
|S|   |       |       |       |
+ + +-+ + +-+ +-+-+ + + +-+-+ +
| |     |   |   |   | | |   | |
+ + +-+-+-+ +-+ + +-+ + + + + +
| |       | | |   | | | | | | |
+ +-+-+-+-+ + +-+-+ + + +-+ + +
|         | |     |   |   |   |
+-+-+-+-+ + +-+-+ + +-+-+ + +-+
|   |   |   |     | |     | | |
+ + + + +-+-+ +-+-+ +-+ +-+ + +
| | | |       |   |   | | |   |
+ + + +-+-+ + + + +-+ + + +-+ +
| | |   |   | | |     | |     |
+-+ +-+ + +-+-+ +-+-+-+ + +-+-+
|     | |       |       |   | |
+ +-+-+ +-+-+-+-+-+ +-+-+-+ + +
| |   | |       |   |   |   | |
+ + + + +-+-+ + + +-+ + + +-+ +
| | | | |   | |   |   | |     |
+ + + + + + + +-+-+ +-+ +-+-+ +
|   |   | | |   |   |       | |
+ +-+-+-+ + + + +-+ +-+-+-+-+ +
|         | | |   |           |
+-+-+-+-+-+ + +-+ +-+ +-+-+-+-+
|     |   | |   |   |   |   | |
+-+ + + +-+ +-+-+-+ +-+ + + + +
|   |   |   |     | | | | | | |
+ +-+-+-+ +-+ +-+ + + + + + + +
|             |     |     |  E|
+-+-+-+-+-+-+-+-+-+-+-+-+-+-+-+
