+-+-+-+-+-+-+
|S  |     | |
+-+ + + + + +
| | | | | | |
+ + + + + + +
|   | | |   |
+ +-+-+ +-+ +
| |     | | |
+ +-+ +-+ + +
| |   | |   |
+ + +-+ + +-+
|   |      E|
+-+-+-+-+-+-+
