#############
#S        # #
######### # #
#   #   # # #
# ### # # # #
# #   # # # #
# # ### # # #
#   # # # # #
# ### # # # #
#     # # # #
##### # # # #
#     #    E#
#############
