+---+---+---+---+---+
| O     |           |
+---+   +   +   +   +
|       |   |   |   |
+   +---+---+   +---+
|           |       |
+---+---+   +---+   +
|       |           |
+   +---+---+---+   +
|                 T |
+---+---+---+---+---+
