#############
#S#         #
# ### ##### #
#   # # #   #
### # # # ###
# # # # #   #
# # # # ### #
# # # #   # #
# # # # ### #
# #   #     #
# ##### #####
#          E#
#############
