#########
#O    # #
##### # #
# #   # #
# # ### #
# #   # #
# ### # #
#      T#
#########
