#########
#O  #   #
### ### #
# #     #
# ##### #
#       #
# #######
#      T#
#########
