+---+---+---+---+
| O         |   |
+---+---+   +   +
|   |       |   |
+   +   +---+   +
|   |       |   |
+   +---+   +   +
|             T |
+---+---+---+---+
