+---+---+---+---+
| O     |       |
+---+   +---+   +
|   |           |
+   +---+---+   +
|               |
+   +---+---+---+
|             T |
+---+---+---+---+
