###############################
#S#         #   #       #     #
# # ##### # # # ### # ### ### #
# #   #   # # #   # #       # #
# ##### ### # ### ######### # #
#     #   #   # # #     #   # #
##### ### ##### # # ### # ### #
#   #     # #   # # #   # #   #
# ######### # # # # # ### # # #
#       #     # #   # # # # # #
# ### ### ##### ##### # # # ###
# # #         #   # # #   #   #
# # ########### # # # # ##### #
#   #     #     # # # #     # #
### # ### # ##### # # ####### #
# # #   # #   #     # #     # #
# # ### # ### ####### # ### # #
# # # # #     #   #   # #   # #
# # # # ##### # # # ### # ### #
# # # # #     # #   #   #   # #
# # # # ####### ##### ##### # #
# # # #   #     #     #   #   #
# # # ### # ######### # # ### #
#   #   #   #         # #   # #
# ### ######### ########### # #
#   #         # #           # #
### ### ##### # ### ######### #
# #   # # #   # #   #   #     #
# ### # # # ### # ### # # #####
#       #       #     #      E#
###############################
