+---+---+---+---+---+
| O     |           |
+---+   +---+---+   +
|   |       |       |
+   +---+   +   +---+
|       |   |       |
+   +---+   +   +   +
|           |   |   |
+   +---+---+---+   +
|                 T |
+---+---+---+---+---+
