+-+-+-+-+-+-+
|S|     |   |
+ + +-+-+ + +
| |       | |
+ +-+-+-+-+ +
|         | |
+-+-+-+-+ + +
|     |   | |
+ +-+ + +-+ +
| | |   |   |
+ + +-+-+ + +
|         |E|
+-+-+-+-+-+-+
