#############
#S#     #   #
# # ##### # #
# #       # #
# ######### #
#         # #
######### # #
#     #   # #
# ### # ### #
# # #   #   #
# # ##### # #
#         #E#
#############
