###############################
#S    #         #             #
##### # ### ### ######### # ###
#     #   # #           # #   #
# ####### # ########### # ### #
#     #   #   #       # # #   #
##### ####### # ##### # ### # #
#   #     #   #     # # #   # #
# ####### # ####### # # # ### #
#     #   # #       # # # #   #
##### # ### # ####### # # #####
#     #   # # # #     # #     #
# ####### # # # # ##### # ### #
# #       # # # #     # #   # #
# # ####### # # ##### # ##### #
# # #   #   #   #   #     #   #
# # # # # ####### # ##### # # #
# #   # #   #     #     #   # #
# ##### # # # ######### ##### #
#   #   # #   #     #   #   # #
# # # ### ##### ### # ##### # #
# #   # # #   # # # # #     # #
# ##### # # # # # # # # ##### #
#     #     # # #   # #     # #
##### ######### # ### ##### # #
#   #           #   #     #   #
# # ############### ##### # ###
# #   #   #       #   #   #   #
# ##### # # # ####### # ##### #
#       #   #           #    E#
###############################
