#######
#S    #
##### #
#   # #
# # # #
# #  E#
#######
