#############
#S#     #   #
# ### # ### #
#     #   # #
######### # #
# #     # # #
# # ### # # #
# # # # # # #
# # # # # # #
# #   #   # #
# ### ##### #
#          E#
#############
