###################
#O      #     #   #
####### # # # # # #
#     # # # # # # #
# ##### ### # # # #
# #     #   #   # #
# # ##### #########
#   #   #   #     #
# ### ### # # ### #
#   #     #     # #
### # ######### # #
# # #   #     # # #
# # ### # ### ### #
#   #   # # #     #
# ##### # # ##### #
# #   # # #       #
# # # ### # #######
#   #     #      T#
###################
