+---+---+---+---+---+---+---+---+---+
| O             |           |       |
+---+---+---+   +   +   +   +   +   +
|           |   |   |   |   |   |   |
+   +---+---+   +---+   +   +   +   +
|   |           |       |       |   |
+   +   +---+---+   +---+---+---+---+
|       |       |       |           |
+   +---+   +---+   +   +   +---+   +
|       |           |           |   |
+---+   +   +---+---+---+---+   +   +
|   |   |       |           |   |   |
+   +   +---+   +   +---+   +---+   +
|       |       |   |   |           |
+   +---+---+   +   +   +---+---+   +
|   |       |   |   |               |
+   +   +   +---+   +   +---+---+---+
|       |           |             T |
+---+---+---+---+---+---+---+---+---+
