###################
#O#         #   # #
# ##### ### # # # #
#       # #   # # #
######### ##### # #
# #           #   #
# # ##### ### ### #
#   #   # #     # #
# ##### # ##### # #
# #     #     # # #
# # ### ##### ### #
#   # #   # #     #
##### ### # #######
# #   #   #       #
# # # # ### ##### #
#   # # #   #   # #
# ### # ### # # # #
#   #       # #  T#
###################
