+---+---+---+---+---+---+---+---+---+
| O             |   |               |
+---+---+---+   +   +   +---+---+   +
|       |       |       |           |
+   +   +   +---+---+   +   +---+   +
|   |       |       |   |       |   |
+   +---+---+   +   +---+---+   +   +
|       |       |           |   |   |
+---+   +   +   +---+---+   +   +   +
|   |   |   |   |       |   |   |   |
+   +   +---+   +   +   +   +   +   +
|   |       |   |   |   |   |   |   |
+   +---+   +   +   +---+   +   +---+
|       |   |   |           |       |
+   +---+   +   +---+   +---+---+   +
|           |       |   |       |   |
+   +---+---+---+   +   +   +   +   +
|                   |       |     T |
+---+---+---+---+---+---+---+---+---+
