#########################################
#O          #     #   #   #     #       #
########### # ### # # # # ##### # ### ###
#       #   #   #   #   #     #     #   #
# ####### ### # ############# ######### #
# #       #   #           # #   #   #   #
# # ############### ##### # ### # # # ###
#   #             # #   # #   #   # #   #
# ### ########### ### # # # # ##### ### #
#   # #         # #   #   # # #   #   # #
### # # ######### # ####### # # # ### # #
# #   #       #   # #   #   # # # # # # #
# ##### ##### # ### ### # # # # # # # # #
#       #     #   #   #   # #   #   #   #
# ####### ### ### # # # ### ########### #
# #   #   #     # # # #   #           # #
# ### # ### ##### ### ##### ######### # #
#     #   # #   # #   #   #     #   # # #
# ##### # ### # # # ### # ##### ### # # #
# #   # #   # #   #     # #   #     #   #
# # # ##### # ##### ##### ### ##### #####
# # #       # #     #   # #   #   # #   #
# # ####### # ##### # # # # ### # # # # #
# # # #     # #   #   # # # #   #   # # #
### # # ##### # # ##### # # # ######### #
#   # # #     # #   #   # # # #       # #
# ### # # ##### ### ##### # # # ### # # #
# #     # #       #       # # # #   #   #
# ##### # # ##### ######### # ### ##### #
#     # # #   #   #   #     #     #   # #
# ### # # # ### ### ### # # ####### ### #
# #   # # # #   #       # #   #     #   #
### ##### # # ########### ##### # ### ###
#   #     # # #           #     #     # #
# ### ##### # # # ####### # ########### #
#     # #   # # # #   # # #           # #
# ##### # ### # ### # # # ########### # #
#     #     # #     # #           #   # #
##### ####### # ##### ############# ### #
#             #     #                  T#
#########################################
