+---+---+---+---+---+---+---+---+---+---+---+---+---+---+---+---+---+---+---+---+
| O |                       |           |       |       |                   |   |
+   +---+---+---+   +---+   +---+   +   +---+   +   +   +   +---+   +---+   +   +
|                   |       |       |       |       |   |       |   |   |   |   |
+---+---+---+---+---+   +---+   +---+---+   +   +---+   +---+   +   +   +   +   +
|                   |       |           |   |   |   |           |   |           |
+   +---+---+   +   +---+   +---+---+   +   +   +   +---+---+---+   +---+---+   +
|   |       |   |       |       |       |   |               |   |           |   |
+   +   +   +   +---+---+---+   +   +---+   +   +---+---+   +   +---+---+   +   +
|   |   |   |               |   |       |   |   |       |       |           |   |
+   +   +   +   +---+---+   +   +   +   +   +   +   +   +---+   +   +---+---+   +
|   |   |   |           |   |   |   |   |   |   |   |       |   |   |       |   |
+---+   +   +---+---+---+   +   +---+   +   +---+   +---+   +---+   +---+   +   +
|       |       |           |   |       |           |   |           |       |   |
+   +---+---+   +   +---+---+   +   +---+---+---+---+   +---+---+---+   +---+   +
|           |   |           |   |   |   |               |               |       |
+---+---+   +   +---+---+   +   +   +   +   +   +---+---+   +   +---+   +   +---+
|       |   |           |   |       |   |   |               |   |       |       |
+   +   +   +---+---+   +   +---+---+   +   +---+---+---+---+   +---+---+---+   +
|   |       |   |       |   |           |               |       |           |   |
+   +---+---+   +   +---+   +   +   +---+---+---+---+   +   +---+   +   +---+   +
|       |       |       |   |   |               |       |           |   |       |
+---+   +   +   +---+   +   +   +---+   +---+---+   +---+---+---+---+   +   +---+
|       |   |       |   |   |       |           |       |           |   |   |   |
+   +---+   +   +---+   +   +---+   +---+---+   +---+   +   +---+---+   +   +   +
|       |   |           |           |       |   |       |           |       |   |
+   +   +---+   +---+---+---+---+---+   +   +   +   +---+   +---+   +---+---+   +
|   |       |           |               |       |       |       |               |
+   +---+   +---+---+   +   +---+---+---+---+   +---+   +---+   +---+---+---+   +
|       |           |   |   |                       |       |               |   |
+---+---+---+   +   +   +   +---+---+---+---+---+---+---+   +---+   +---+---+   +
|           |   |   |       |       |                   |       |   |           |
+   +---+   +---+   +---+   +   +   +   +---+---+   +---+---+   +---+   +---+---+
|       |           |       |   |       |       |           |   |       |       |
+   +   +---+---+---+   +---+   +---+---+---+   +---+---+   +   +   +---+   +   +
|   |       |               |   |                   |   |       |           |   |
+   +---+   +---+---+---+---+   +   +---+---+---+   +   +---+---+---+   +---+   +
|       |       |           |   |           |   |   |               |   |       |
+---+   +---+   +   +---+   +   +---+---+   +   +   +   +---+---+   +---+   +   +
|           |           |                   |           |                   | T |
+---+---+---+---+---+---+---+---+---+---+---+---+---+---+---+---+---+---+---+---+
