+---+---+---+---+---+---+---+---+---+---+---+---+---+---+---+---+---+---+---+---+
| O     |   |                               |               |                   |
+---+   +   +   +---+---+   +   +---+---+---+   +---+---+   +   +---+   +---+   +
|       |       |       |   |           |       |       |       |   |       |   |
+   +---+   +---+   +   +---+   +---+   +   +---+   +   +---+---+   +---+   +   +
|   |           |   |       |   |       |   |       |           |       |   |   |
+   +---+---+   +   +---+   +   +   +---+   +   +---+---+---+   +   +---+   +   +
|       |       |   |       |   |       |       |               |       |   |   |
+---+   +---+---+   +   +---+---+---+   +---+---+   +---+---+---+---+   +   +   +
|   |           |   |       |       |                                   |   |   |
+   +---+---+   +   +---+   +   +   +   +---+---+---+   +---+---+---+---+   +   +
|           |       |   |   |   |   |   |       |   |   |                   |   |
+   +---+---+---+---+   +   +   +   +---+   +   +   +   +   +---+---+---+---+   +
|                       |   |   |           |   |   |   |       |               |
+   +---+---+---+   +---+   +   +---+---+---+   +   +   +---+   +   +---+---+---+
|       |       |       |       |           |   |   |       |   |           |   |
+---+   +---+   +---+   +---+---+---+   +---+   +   +---+   +   +---+---+   +   +
|   |           |           |       |       |   |           |   |       |       |
+   +---+---+   +   +---+   +   +   +---+   +   +---+---+---+   +   +   +---+---+
|       |       |   |           |   |       |               |       |           |
+   +   +   +---+   +---+---+---+   +   +---+---+---+---+   +---+---+---+---+   +
|   |   |   |   |       |       |   |   |                   |                   |
+   +---+   +   +---+   +---+   +   +   +   +---+---+---+---+   +---+---+---+---+
|       |       |   |       |           |   |           |                       |
+   +   +---+   +   +---+   +---+---+---+   +   +---+   +---+---+   +---+---+   +
|   |       |   |       |               |       |   |           |   |       |   |
+   +   +---+   +   +   +---+---+---+   +---+---+   +---+---+   +   +   +---+   +
|   |   |       |   |               |                       |   |       |       |
+   +   +   +---+   +---+---+   +---+   +---+---+---+---+---+   +---+---+   +   +
|   |   |   |       |           |       |                   |               |   |
+   +   +   +   +   +   +---+---+   +   +   +---+---+---+   +---+---+---+---+   +
|   |       |   |   |   |       |   |   |       |       |               |   |   |
+   +---+---+   +   +   +   +   +   +---+---+   +   +---+---+   +---+   +   +   +
|   |           |   |       |   |   |           |           |       |   |   |   |
+   +---+---+   +   +---+---+   +   +   +---+---+---+---+   +---+   +   +   +   +
|           |   |   |       |   |   |                       |   |   |       |   |
+---+---+   +---+   +   +---+   +   +---+---+---+---+---+   +   +   +---+---+   +
|       |   |       |           |       |           |       |   |   |       |   |
+   +   +   +   +---+   +---+---+---+   +   +---+   +   +---+   +   +   +   +   +
|   |           |                   |           |               |       |     T |
+---+---+---+---+---+---+---+---+---+---+---+---+---+---+---+---+---+---+---+---+
