#########################################
#O#           #     #   #   #         # #
# ####### ### ### # ### # # # ### ### # #
#         #   #   #   #   # #   # # # # #
########### ### ##### # ### ### # # # # #
#         #   #     # # # #     # #     #
# ##### # ### ##### # # # ####### ##### #
# #   # #   #   #   # #       # #     # #
# # # # ####### # ### # ##### # ##### # #
# # # #       # #   # # #   #   #     # #
# # # # ##### # # # # # # # ### # ##### #
# # # #     # # # # # # # #   # # #   # #
### # ####### # ### # ### ### ### ### # #
#   #   #     # #   #     # #     #   # #
# ##### # ##### # ######### ####### ### #
#     # #     # # # #       #       #   #
##### # ##### # # # # # ##### # ### # ###
#   # #     # #   # # #       # #   #   #
# # # ##### # ##### # ######### ####### #
# #   # #   # #     #       #   #     # #
# ##### # ### # # ######### # ### # ### #
#   #   #   # # #       #   #     # #   #
### # # ### # # ### ##### ######### # ###
#   # #   # # #   #     #   #     # # # #
# ### # ### # ### ##### ### # ##### # # #
#   # #     #     #   # #   #     #   # #
# # ### ########### # # # ### ### ##### #
# #   #     #       #   #   #   #       #
# ### ##### # ######### ### ### ####### #
#   #     # # #           #   #       # #
####### # # # ############### ### ##### #
#     # # #   #   #         #   # #     #
# ### ### ### # # # ##### ##### ### #####
#   #     #   # #   #   #     # #   #   #
# # ####### ### ####### ##### # # ### # #
# #   #       # #         # #   #     # #
# ### ######### # ####### # ####### ### #
#   #   #     # #     # # #       # #   #
### ### # ### # ##### # # # ##### ### # #
#     #     #         #     #         #T#
#########################################
