#########################################
#O  # #               #       #         #
### # # ##### # ####### ##### # ### ### #
#   #   #   # #     #   #   #   # #   # #
# ### ### # ### ### # ### # ##### ### # #
# #     # #   # #   # #   #     #   # # #
# ##### # ### # # ### # ####### # ### # #
#   #   # #   # #   #   #       #   # # #
### ##### # ####### ##### ######### # # #
# #     # #   #   #                 # # #
# ##### # ### # # # ####### ######### # #
#     #   # # # # # #   # # #         # #
# ######### # # # ### # # # # ######### #
#           # # #     # # # #   #       #
# ####### ### # ####### # # ### # #######
#   #   #   #   #     # # #   # #     # #
### ### ### ####### ### # ### # ##### # #
# #     #     #   #   # #     # #   #   #
# ##### # ### # # ### # ####### # # #####
#   #   # #     # #   #       #   #     #
# # # ### ####### # ######### ######### #
# # # # #   #   # # #         #         #
# ### # ### ### # # # ######### #########
#   #   # #   #     # #     #           #
# # ### # ### ####### # ### ##### ##### #
# #   # #   #       #   # #     # #   # #
# # ### # # ####### ##### ##### # # ### #
# # #   # #       #           # #   #   #
# # # ### ##### ### ########### ##### # #
# # # #   #     #   #         #       # #
# # # # # # ##### # # ####### ######### #
# #   # # # #   # # #   #   #       # # #
# ##### # # # # # ##### # ##### ### # # #
# #     # #   # # #     #     #   # # # #
# ##### # ##### # # ######### ### # # # #
#     # # #   # # #           # # #   # #
##### ### # ### # ########### # # ##### #
#   # #   #     #   #     #   # # #   # #
# # # # ### ####### # ### # ### # # # # #
# #     #         #     #       #   #  T#
#########################################
