+---+---+---+---+---+---+---+---+---+---+---+---+---+---+---+---+---+---+---+---+
| O                     |           |       |       |           |               |
+---+---+---+---+---+   +   +---+   +   +   +   +   +---+---+   +   +---+   +---+
|               |       |       |       |       |           |           |       |
+   +---+---+---+   +---+   +   +---+---+---+---+---+---+   +---+---+---+---+   +
|   |               |       |                       |   |       |       |       |
+   +   +---+---+---+---+---+---+---+   +---+---+   +   +---+   +   +   +   +---+
|       |                           |   |       |   |       |       |   |       |
+   +---+   +---+---+---+---+---+   +---+   +   +   +   +   +---+---+   +---+   +
|       |   |                   |   |       |       |   |   |       |       |   |
+---+   +   +   +---+---+---+---+   +   +---+---+---+   +   +   +   +---+   +   +
|   |       |               |       |   |       |       |   |   |   |   |   |   |
+   +---+---+   +---+---+   +   +---+   +---+   +   +   +   +   +   +   +   +   +
|               |           |       |       |       |   |       |       |       |
+   +---+---+---+   +---+   +---+   +   +   +   +---+   +---+---+---+---+---+   +
|   |       |       |           |   |   |   |       |                       |   |
+   +---+   +   +---+   +---+---+   +---+   +---+---+   +---+---+---+---+   +   +
|           |       |   |       |   |       |       |           |       |   |   |
+   +---+---+   +   +---+   +   +   +   +---+   +   +---+---+   +---+   +   +   +
|   |       |   |       |   |       |           |   |       |           |       |
+   +   +   +---+---+   +   +---+---+   +---+---+   +---+   +---+---+   +---+---+
|   |   |               |   |           |       |   |       |       |   |       |
+   +   +---+---+---+   +   +---+---+   +   +   +   +   +---+   +   +   +   +   +
|   |   |   |           |   |       |       |   |   |   |       |       |   |   |
+---+   +   +   +---+---+   +   +   +---+---+   +   +   +   +---+---+---+---+   +
|       |   |   |           |   |       |       |   |   |   |               |   |
+   +---+   +   +   +---+---+   +---+   +---+---+   +   +   +   +---+   +   +   +
|   |           |   |               |               |   |   |   |       |       |
+   +---+---+   +   +   +---+---+   +---+---+---+---+   +   +---+   +---+---+   +
|           |   |   |       |       |       |           |           |       |   |
+   +---+   +   +   +   +---+   +---+   +---+   +   +   +---+---+---+   +---+   +
|   |       |   |   |   |       |               |   |       |           |       |
+---+   +---+---+   +   +   +---+---+---+---+---+   +---+---+   +   +---+   +---+
|       |           |   |   |                       |           |           |   |
+   +---+   +---+---+   +   +   +   +---+---+---+   +   +---+---+---+---+---+   +
|           |   |       |   |   |   |       |   |   |                       |   |
+   +---+---+   +   +---+   +   +---+   +   +   +   +---+---+---+---+---+   +   +
|           |           |   |           |   |                       |       |   |
+---+---+   +---+---+---+   +   +---+---+   +---+---+---+---+---+---+   +---+   +
|                           |           |                                     T |
+---+---+---+---+---+---+---+---+---+---+---+---+---+---+---+---+---+---+---+---+
