#############
#S#     #   #
# # ### ### #
# # # # #   #
# # # # # # #
#   #   # # #
##### ### ###
#   # #     #
# # # # ### #
# #   # #   #
# ####### # #
#         #E#
#############
