###########################################
#O  #                   # #             # #
### ### ############# # # # ####### # # # #
# #   # #             #   # #     # # # # #
# ### # # ######### ####### # ### ### # # #
#     # #     #   # #     # #   #   # #   #
# ######### # # # ### ### # ### ### # ### #
#         # #   #       #     # #   #   # #
######### # ################### # ##### # #
#   # #   #   #         #   #   #   #   # #
# # # # ####### ####### # # # ##### # #####
# # # # #     # #     #   #   #   # # #   #
# # # # ### # # # # # ######### ### # # # #
# #   #     #   # # #     #   #     #   # #
# ############### # ##### # ### ######### #
#       #         # # #   # #   #       # #
# ### # ########### # # ### # ### ##### # #
#   # #     #       #       #     # #   # #
# ### ##### # ##################### # ### #
# #   #       #     #               #     #
### # ####### # ### # ############# ##### #
#   # #   #   #   #   #           #       #
# ##### # ####### ##### ######### #########
#     # #       # #   #   #     #         #
# ### # ####### # # # # ### ### ### ##### #
#   #   #     #   # # # #   # #   #     # #
### ##### ### ##### # ### ### ### ##### # #
# # #   #   #       # #   #   # #       # #
# # # # ### ####### # # ### # # ######### #
# #   # #       #   # #   # #     #       #
# ##### ######### ### ### # ##### # #######
#     #       #   # #     # #   # # #     #
# # # ####### # ### ####### # # ### ##### #
# # # #     #   #         #   #   #       #
### ### ### ####### # ##### ##### ####### #
#   #   # #         # #   # #   #   #   # #
# ### ### ##### ####### # # ### # # # # # #
# #       #     #       #   #   # # # # # #
# # ####### ##### ########### # # ### # # #
#   #       #   #   #       # # #     # # #
# ### ####### # ### # ##### # # ####### # #
#   #         #       #       #       #  T#
###########################################
