###########################################
#O  #     #                     #         #
### # ### ### ##### ########### # ##### # #
#   # #       #     #   #     # #     # # #
# ### ### ####### ### # # ### # ### ### # #
# #     # #     # #   # # #   # #   #   # #
# ##### ### ### ### ### # # ### # ### ### #
#     #       # #     #   # #   #   #   # #
##### # ##### # # ######### # ######### # #
#   # # #   # #     #       #         # # #
# # # ### # ######### ############### # ###
# # #     #       #   #   #         # #   #
### ############# # ### ### ####### # ### #
#           #     #   #   #       #   #   #
# ########### ####### # # ####### ##### # #
#             #       # #   #   #       # #
# ############# ########### # # ######### #
# #             #         #   # #       # #
# ##### ############# ### ##### # ##### # #
# #     #         #   #       # #     #   #
# # ####### ##### # ######### # ##### #####
#   #     # # #     #       #   #     #   #
##### ### # # # ##### ##### ##### ##### # #
# #   # # # # #   #   #   #       #     # #
# # # # # # # ### # ### ########### #######
#   # #   # # #   # # #           #       #
# ### # ### # # ### # # ##### ### ### ### #
#   # # #   #   #   #   #     # #   #   # #
### # # # # ##### ####### ##### ### # ### #
# # # # # #   #   #       #       # # #   #
# # # # ##### # ### ####### ### # # # # ###
# # # #     # # #   #   #   # # # # # #   #
# # # ##### # # # ### # # ### # ### ##### #
#   #   #   # #   #   #   #   # #   #     #
####### # ### ##### ######### # # ### #####
#       #       # # #       # #   #       #
# ############# # # # # ### # ##### ##### #
#       #   #     # # # # # #     #     # #
# ##### # # ##### # # # # # ### # ####### #
# #   # # #     # # # # #   #   # #       #
# ### # # ##### ### ### # ### ### # ##### #
#     #       #         #     #     #    T#
###########################################
