###########################################
#O  #           #         #       #       #
### # # ####### # ####### ##### # ### ### #
# # # # #     # #   #   # #     #   #   # #
# # # # # ### # ### # ### # ####### ### ###
#   # # # #   #   # #   # #       #   #   #
# ##### # # ##### # # # # # ##### ### ### #
# #   # # #     # # # # # #     #   #   # #
# # # # # ####### # # # # ######### ### # #
#   #   #   #   # # # # # #       #   # # #
########### # # # # ### # # ##### ### # # #
#   #       # #   # #   # #   # # #   #   #
# # # ### ### ##### # # # ### # # # ##### #
# #     # #   #     # # #     #   #     # #
# ####### # ### ##### # ####### ### ### ###
# #   #   #   # #     #     #   #     #   #
# # # # ##### # # # ######### ########### #
#   # #       # # # #     #   #   #     # #
##### ######### # # # ### # ### # # ### # #
# #   #   #     # #     # # #   #   #   # #
# # ### ### ### ### ##### # # # ####### # #
#   #         #   # # #   #   # #     #   #
# ### ####### ### # # # ####### # ### ### #
# #     #   #   # #   #       # #   #   # #
# # ##### # # ### ########### # ### ### ###
# #   #   # # #   #   #     #   #     #   #
# ### # ### ### ### # # ### ##### ####### #
# #   # # #   #     #   # #       #       #
# ##### # ### ######### # ######### ##### #
#   #   #   #         #     #     # #   # #
### # ##### ######### # ##### ### # ### # #
# #   #           # # # #     #   #   #   #
# ##### ######### # # # # ##### ### # ### #
#       #     #     # # #     #   # #   # #
# ##### # ### ####### # ##### ### # ### # #
# #     #   #   #     #     # #   #   # # #
### ### ### ### # ########### # ### ### # #
#   #     # # #   #           # # # #   # #
# # ##### # # ##### # ######### # # # ### #
# # #   # # #     # # #   #   # #   # # # #
# ### # ### # ### ### # # # # # ##### # # #
#     #       #       # #   #         #  T#
###########################################
