+---+---+---+---+---+---+---+---+---+---+---+---+---+---+---+---+---+---+---+---+---+
| O     |           |                                           |                   |
+---+   +   +---+   +---+   +---+---+   +---+---+---+---+---+   +   +---+---+   +   +
|       |   |               |           |       |           |   |           |   |   |
+   +---+   +---+   +---+---+---+   +---+   +   +   +---+   +   +---+   +---+   +   +
|   |           |   |           |   |       |   |   |       |   |       |       |   |
+   +---+---+   +---+   +---+   +---+   +---+   +   +   +---+   +   +---+   +---+   +
|           |               |   |           |       |   |       |       |       |   |
+---+---+   +   +---+---+   +   +   +---+---+---+---+   +   +---+---+---+---+   +   +
|       |   |   |       |   |           |               |                   |   |   |
+   +   +   +---+   +   +---+---+---+---+   +---+---+---+---+---+---+---+   +   +---+
|   |   |           |               |       |       |                   |   |       |
+---+   +---+---+---+---+---+---+   +   +---+   +---+   +---+---+---+   +   +---+   +
|                       |           |       |       |               |       |       |
+   +---+---+---+---+---+   +---+---+---+   +   +   +---+---+---+   +---+---+   +   +
|                           |               |   |       |       |               |   |
+   +---+---+---+---+---+---+   +---+---+---+---+---+   +   +   +---+---+---+---+   +
|   |                           |                   |       |   |               |   |
+   +---+---+   +---+---+---+---+---+---+   +---+   +---+---+   +   +---+---+   +   +
|   |           |                   |       |               |   |           |       |
+   +   +---+---+---+   +---+---+   +   +---+---+---+---+   +   +---+---+   +---+---+
|       |           |   |   |           |               |       |           |       |
+---+---+   +---+   +   +   +   +---+---+   +---+---+   +---+---+   +---+---+   +   +
|   |       |   |   |   |   |       |       |       |               |           |   |
+   +   +   +   +   +   +   +---+   +   +---+   +---+---+---+---+---+   +---+---+---+
|       |   |       |   |   |       |   |   |                       |               |
+   +---+   +   +---+   +   +   +---+   +   +   +---+---+   +---+   +---+   +---+   +
|       |   |   |       |       |       |       |           |   |       |       |   |
+---+   +   +   +   +   +---+---+   +---+---+---+   +---+---+   +---+   +   +---+   +
|   |   |   |   |   |       |       |               |               |   |   |       |
+   +   +   +   +---+---+   +   +---+   +---+---+---+   +---+   +   +   +   +   +---+
|   |   |   |           |   |   |       |       |       |   |   |   |   |   |       |
+   +   +   +---+---+   +   +   +   +---+   +   +   +---+   +   +---+   +---+---+   +
|       |       |       |   |       |       |       |       |   |       |           |
+---+---+---+   +   +---+   +---+---+   +---+---+---+---+   +   +   +---+   +---+---+
|               |               |   |   |               |   |       |               |
+   +---+---+---+---+---+---+   +   +   +   +   +---+   +   +---+---+   +---+---+   +
|               |       |           |   |   |   |   |   |           |           |   |
+   +---+---+   +   +   +---+---+   +   +   +   +   +   +---+   +   +---+---+---+   +
|   |       |   |   |           |   |   |   |   |       |       |   |               |
+   +---+   +   +   +---+---+   +---+   +---+   +   +---+   +---+   +   +---+---+   +
|           |               |                   |           |           |         T |
+---+---+---+---+---+---+---+---+---+---+---+---+---+---+---+---+---+---+---+---+---+
