+---+---+---+---+---+---+---+---+---+---+---+---+---+---+---+---+---+---+---+---+---+
| O     |                       |                   |               |               |
+---+   +   +   +---+---+---+   +   +---+---+---+   +---+---+   +   +---+   +---+   +
|   |   |   |   |           |   |       |       |   |           |       |       |   |
+   +   +   +   +   +---+   +   +---+   +   +---+   +   +---+---+---+   +---+   +---+
|       |   |   |   |       |       |   |       |   |               |       |       |
+   +---+---+   +   +   +---+---+   +   +   +   +   +   +---+---+   +---+   +---+   +
|   |       |   |   |           |   |   |   |   |   |           |       |       |   |
+   +   +   +   +   +---+---+---+   +   +   +   +   +---+---+---+---+   +---+   +   +
|       |       |       |       |   |   |   |   |   |               |       |   |   |
+---+---+---+---+---+   +   +   +   +   +---+   +   +   +---+---+   +---+   +   +   +
|       |               |   |       |   |       |   |       |   |   |       |       |
+   +   +   +---+   +---+   +---+---+   +   +   +   +---+   +   +   +   +---+---+   +
|   |           |   |       |           |   |   |           |       |           |   |
+   +---+---+---+   +   +---+   +---+---+   +   +---+---+---+   +---+   +---+   +---+
|   |       |       |       |   |           |           |       |           |       |
+   +   +   +   +---+---+   +   +   +   +---+---+---+---+   +---+---+---+---+---+   +
|       |   |               |   |   |   |           |       |       |           |   |
+---+---+   +---+---+---+---+   +   +   +   +---+   +   +---+   +   +   +---+   +   +
|   |       |       |           |   |           |   |   |       |       |       |   |
+   +   +---+   +---+   +---+   +---+   +---+---+   +   +   +   +---+---+---+   +   +
|       |                   |       |   |   |       |       |   |           |       |
+   +---+   +---+---+---+   +---+   +   +   +   +---+---+---+   +   +---+   +---+   +
|   |           |       |       |   |       |               |   |       |       |   |
+   +   +---+---+   +   +   +---+   +---+---+---+---+---+   +   +---+   +---+   +---+
|   |       |       |   |   |       |       |           |       |           |       |
+   +---+   +   +---+   +---+   +---+   +   +   +---+   +---+---+   +---+---+---+   +
|   |       |   |   |       |           |       |   |               |               |
+   +---+---+   +   +---+   +---+---+---+---+   +   +---+---+---+---+   +---+---+   +
|       |       |       |                   |           |           |   |       |   |
+---+   +   +---+---+   +---+---+---+---+   +   +---+---+   +---+   +   +---+   +   +
|   |       |                       |   |   |   |           |       |       |       |
+   +---+---+   +---+---+---+---+   +   +   +   +   +---+---+   +---+   +   +---+   +
|               |           |           |   |   |           |       |   |       |   |
+   +---+---+   +   +---+   +---+---+---+   +   +---+---+   +---+   +   +---+   +   +
|   |           |       |       |           |           |   |       |       |   |   |
+---+   +---+   +---+   +---+   +   +---+---+---+---+---+   +   +---+   +---+   +   +
|       |           |   |   |       |                       |   |   |   |       |   |
+   +   +---+---+   +   +   +---+---+   +   +---+---+---+---+   +   +   +   +---+   +
|   |   |       |   |   |           |   |   |       |       |   |       |   |   |   |
+   +---+   +   +---+   +   +---+   +---+   +   +   +   +   +   +---+---+   +   +   +
|           |               |               |   |       |                   |     T |
+---+---+---+---+---+---+---+---+---+---+---+---+---+---+---+---+---+---+---+---+---+
