+---+---+---+---+---+---+---+---+---+---+---+---+---+---+---+---+---+---+---+---+---+
| O     |                                       |   |                           |   |
+---+   +---+   +---+---+---+---+---+---+   +   +   +   +---+---+---+   +   +   +   +
|   |       |   |                           |       |   |           |   |   |   |   |
+   +---+   +   +   +---+---+---+---+   +---+---+---+   +   +---+   +---+   +   +   +
|           |   |           |       |   |           |   |       |       |   |       |
+   +---+---+---+---+   +   +   +   +---+   +---+   +   +---+   +---+   +   +---+   +
|                   |   |       |               |           |   |       |       |   |
+---+---+---+---+   +   +---+---+---+---+---+---+---+---+---+   +   +---+---+   +   +
|       |   |       |       |                   |       |       |       |       |   |
+   +   +   +   +---+---+---+   +---+---+---+   +   +   +   +---+---+   +   +---+---+
|   |   |   |   |           |   |           |       |       |       |   |   |       |
+   +   +   +   +---+   +   +   +   +   +   +---+---+---+---+   +---+   +   +   +   +
|   |       |           |       |   |   |           |       |           |       |   |
+   +---+---+---+---+---+---+---+   +   +---+---+   +   +---+   +---+---+---+---+   +
|               |                   |   |   |       |   |       |               |   |
+   +---+   +   +---+---+---+---+---+   +   +   +---+   +   +---+   +---+---+   +   +
|       |   |           |               |               |           |   |       |   |
+   +---+   +---+---+   +   +---+---+---+---+---+---+---+---+---+---+   +   +---+   +
|   |       |               |           |                               |           |
+---+   +   +---+---+---+   +   +---+   +   +---+---+---+---+---+---+   +---+---+   +
|       |   |       |       |       |       |                       |               |
+   +---+---+   +   +---+---+---+   +---+---+   +---+---+---+---+   +---+---+---+---+
|           |   |               |   |       |       |           |                   |
+   +---+   +   +---+---+---+   +   +   +   +   +---+   +---+   +---+   +---+---+   +
|       |       |           |       |   |   |   |       |   |       |           |   |
+---+   +---+---+   +---+   +---+---+   +   +---+   +---+   +---+   +---+---+   +   +
|   |   |       |       |               |   |       |       |   |               |   |
+   +   +   +   +---+   +---+---+---+   +   +   +---+   +   +   +---+---+---+---+   +
|   |       |   |               |       |   |       |   |           |               |
+   +---+---+   +---+---+---+---+   +---+   +---+   +   +---+---+   +   +---+---+---+
|           |               |       |   |           |   |       |   |   |           |
+   +   +   +---+---+---+   +   +---+   +---+---+---+   +   +   +---+   +---+---+   +
|   |   |   |           |       |                   |       |       |               |
+---+   +---+   +---+   +---+---+---+   +   +---+---+   +---+---+   +---+---+---+   +
|       |       |   |                   |   |       |   |       |       |       |   |
+   +---+   +---+   +---+---+   +---+---+---+   +   +   +---+   +   +   +   +   +   +
|   |               |           |               |       |       |   |   |   |   |   |
+   +   +---+---+---+   +---+---+   +---+---+---+---+---+   +   +   +---+   +   +   +
|       |               |       |       |               |   |   |           |   |   |
+   +---+   +---+---+---+   +   +---+   +   +---+---+   +   +   +---+---+---+   +   +
|       |                   |               |               |               |     T |
+---+---+---+---+---+---+---+---+---+---+---+---+---+---+---+---+---+---+---+---+---+
