#################
#O#         #   #
# ##### ### # # #
# #     # #   # #
# # ##### ##### #
# # #         # #
# # # ####### # #
# # #   #     # #
# # ##### ### # #
# #     # #   # #
# ##### # ##### #
# #     #   #   #
# # ##### # # ###
# # #   # # #   #
# # # ### # ### #
#   #     #    T#
#################
