#################
#O      #       #
####### # ##### #
#   #   #     # #
### # ######### #
#   #         # #
# ########### # #
# #     #   #   #
# # ### # # ### #
#   # #   # #   #
# ### ##### # ###
#     # #   # # #
##### # # ### # #
#   # # # #   # #
# # # # # # ### #
# #     #      T#
#################
