+---+---+---+---+---+---+---+---+
| O |                   |       |
+   +---+---+   +---+   +   +   +
|   |           |   |       |   |
+   +   +---+---+   +---+---+   +
|   |   |                   |   |
+   +   +   +---+---+---+   +   +
|   |   |       |           |   |
+   +   +---+---+   +---+   +   +
|   |           |   |       |   |
+   +---+---+   +   +---+---+   +
|   |           |       |       |
+   +   +---+---+   +   +   +---+
|   |   |       |   |   |       |
+   +   +   +---+   +   +---+   +
|       |           |         T |
+---+---+---+---+---+---+---+---+
