+---+---+---+---+---+---+---+---+
| O                 |           |
+---+---+---+---+   +   +   +---+
|       |           |   |       |
+   +   +   +---+---+---+---+   +
|   |   |   |       |           |
+   +   +   +   +   +   +---+   +
|   |   |       |       |   |   |
+   +---+---+---+---+---+   +   +
|                       |       |
+---+---+   +---+---+---+   +---+
|           |           |       |
+   +---+   +   +---+   +---+   +
|       |   |       |   |       |
+   +   +---+---+   +   +   +---+
|   |               |         T |
+---+---+---+---+---+---+---+---+
