+---+---+---+---+---+---+---+---+
| O             |               |
+---+---+---+   +   +---+---+   +
|       |       |           |   |
+---+   +   +---+---+---+---+   +
|       |                   |   |
+   +---+---+---+---+---+   +   +
|   |           |       |       |
+   +   +---+   +   +   +---+   +
|       |   |       |   |       |
+   +---+   +---+---+   +   +---+
|           |   |       |   |   |
+---+---+   +   +   +---+   +   +
|       |   |   |   |       |   |
+   +   +   +   +   +   +---+   +
|   |           |             T |
+---+---+---+---+---+---+---+---+
