#################
#O        #     #
######### # # ###
#   #     # #   #
# # # ######### #
# # # #   #     #
# # # # # # ### #
# # #   #   # # #
# ########### # #
#           #   #
##### ####### ###
#     #     #   #
# ### # ### ### #
#   # #   # #   #
# # ##### # # ###
# #       #    T#
#################
