###############################
#S#       # #                 #
# ##### # # # ##### ######### #
# #     #   #   #   # #       #
# # ########### # ### # #######
# #           # # #         # #
# ##### ### ### # ######### # #
#     #   # #   #     #   #   #
##### ##### # ####### # # ### #
#   #     # # #   #   # #     #
# # ##### # # # # # ### #######
# #     # # #   # # #     #   #
# ### # # # ##### # ##### # # #
#   # # # #   #   #   # #   # #
##### # # ### # ##### # ##### #
#     # #   # # # #   #     # #
# ##### ### # # # # ### ##### #
#     #   # #   # #   # #   # #
# ### ##### # ### ### # # # # #
#   # #   # #       # # # # # #
### # # # # ######### # # # # #
# # #   # #     #     # # #   #
# # ##### ##### # ##### # #####
#   #         #   #   #   #   #
##### ##### ####### # # ##### #
#     #     #     # # #     # #
# ########### # # # # ##### # #
# #   #       # # # #     #   #
# # # # ####### ### # ####### #
#   #         #     #        E#
###############################
