+-+-+-+-+-+-+-+-+-+-+-+-+-+-+-+
|S|       | |                 |
+ +-+-+ + + + +-+-+ +-+-+-+-+ +
| |     |   |   |   | |       |
+ + +-+-+-+-+-+ + +-+ + +-+-+-+
| |           | | |         | |
+ +-+-+ +-+ +-+ + +-+-+-+-+ + +
|     |   | |   |     |   |   |
+-+-+ +-+-+ + +-+-+-+ + + +-+ +
|   |     | | |   |   | |     |
+ + +-+-+ + + + + + +-+ +-+-+-+
| |     | | |   | | |     |   |
+ +-+ + + + +-+-+ + +-+-+ + + +
|   | | | |   |   |   | |   | |
+-+-+ + + +-+ + +-+-+ + +-+-+ +
|     | |   | | | |   |     | |
+ +-+-+ +-+ + + + + +-+ +-+-+ +
|     |   | |   | |   | |   | |
+ +-+ +-+-+ + +-+ +-+ + + + + +
|   | |   | |       | | | | | |
+-+ + + + + +-+-+-+-+ + + + + +
| | |   | |     |     | | |   |
+ + +-+-+ +-+-+ + +-+-+ + +-+-+
|   |         |   |   |   |   |
+-+-+ +-+-+ +-+-+-+ + + +-+-+ +
|     |     |     | | |     | |
+ +-+-+-+-+-+ + + + + +-+-+ + +
| |   |       | | | |     |   |
+ + + + +-+-+-+ +-+ + +-+-+-+ +
|   |         |     |        E|
+-+-+-+-+-+-+-+-+-+-+-+-+-+-+-+
