#############
#S#         #
# # ##### # #
# # #   # # #
# ### # # # #
# #   # # # #
# # ### # ###
#   # # #   #
##### # # # #
#   #   # # #
# # # ##### #
# #        E#
#############
