#####
#O# #
# # #
#  T#
#####
