#############
#S        # #
######### # #
#       # # #
### ##### # #
#   #     # #
# ### ##### #
#   #   #   #
### ### # ###
#     # #   #
# ##### ### #
#          E#
#############
