###############################
#S#           #         #     #
# ### ##### # # ##### ### ### #
#   # #   # # #     #     #   #
### # ### # # ####### ##### # #
#   #   # # #       # #   # # #
# ##### # # ####### # # ### # #
# #       #   #   # #   #   # #
# # ######### # # # ### # #####
# #     #     # #   #   #     #
# ####### ##### ##### ####### #
#       #     #   #   #     # #
####### # ### ### ### # ##### #
#     # # #   # #   #   #     #
# ### # ### ### ### ### # ### #
#   # #     # #     #   # #   #
### # ####### # ######### ### #
#   #         # #       #   # #
# ####### # ### ##### # ### # #
# #   # # # #   #     #     # #
# # # # # ### ### ########### #
# # #   #   # #   #     #     #
# # ### ### # ### # ### # #####
# #   # #   #   # # #   #     #
# ### # # ##### # # # ####### #
#   # # #       # # #   #   # #
### # # ######### # ### # # # #
#   # #     #     #   #   # # #
# ### ##### ##### # # ####### #
#     #           # #        E#
###############################
