#############
#S    #     #
##### # ### #
#   #   #   #
# # ##### ###
# # #   #   #
# # # # ### #
# # # #     #
# # # #######
# #   #     #
# ##### ### #
#       #  E#
#############
