+---+---+---+---+---+
| O |           |   |
+   +---+   +   +   +
|           |   |   |
+---+---+---+   +   +
|   |           |   |
+   +   +---+---+   +
|   |           |   |
+   +---+---+   +   +
|                 T |
+---+---+---+---+---+
