#############
#S#     #   #
# ### # ### #
#     #     #
########### #
#         # #
# ### ##### #
# #   #     #
# ##### #####
#       #   #
# ####### # #
#         #E#
#############
