###############################
#S  #           #   #     #   #
### ### ####### # # # ### ### #
# #     #   # #   #   # # #   #
# ####### # # ######### # # # #
#     #   #     #         # # #
# ### # ####### # ######### # #
# # #   #       # # #     # # #
# # ##### ####### # # # # # # #
# #         #   # #   # # # # #
# ####### ### # # # ### # # ###
#       # #   # # #   # # #   #
# ##### # # ### # ### # # ### #
#     # # #   # # #   # #   # #
####### ##### # # ### # ### # #
#     # #     # #   # #   #   #
# ### # # ##### ### # ### ### #
# #     # #   #   # #   #   # #
# ####### # # ### # ####### # #
# #     # # # #   # #     # # #
# # ### # ### # # # # ### # ###
# # # # # #   # # # # # # #   #
# # # # # # # # # # # # # # # #
#     # #   # # # #   #   # # #
# ##### ### ### # ##### ##### #
# # #   #   #   #   # # #   # #
# # # ### ### ##### # # # # # #
# # # #   #   #   #   # # #   #
# # # # ### ### # ##### # ### #
#   #     #     #         #  E#
###############################
