#######################################################
#O                #     #     #               #       #
################# # ### ### # # ####### ##### # ##### #
#   # #         # #   #     # # #       #   #   #     #
# # # # ### # ### ### ####### # # ####### # ##### #####
# #   # # # # #   #   #   #   # # #       # #   # #   #
# ##### # # # # ### ##### # ### ### ####### ### # ### #
# #     # # # #     #     # #   #       #   #   # #   #
# # ##### # ######### ##### # # # ####### ### ### # # #
#   #     #   #       #     # # # #     # #     # # # #
# ### ### ### # # ### # ##### ### # ### # # ### # # ###
#     # # # #   # #   #     # #   # # #   # # #   #   #
####### # # ##### # ####### # # ### # ##### # ####### #
#   #     #   #   # # #   # #   #   #   #   #     #   #
### # ####### # ### # # # # # ### ### ### ##### # # ###
#   # #   #   #   # # # #   #   #   #           # #   #
# ### # # # ##### # # # ####### ### ##### ####### ### #
#       #   #   # #   # # #   # #   #   # #   #       #
# ##### ##### # # # ### # # # # # ### # ### # #########
# #   # #   # # # # #   #   #   #     #   # #         #
# # # ### # # # # # # ######### ######### # ######### #
# # #     # # #   # # #       #       #   # #         #
# # ####### # ##### # ### ### ####### # ### # ### #####
# # #     #   #   # #     #   #   # # #     # #   #   #
### # ######### # # ####### ### # # # ####### ##### # #
#   #           # #   # #   #   # #       #   #     # #
# ### ##### ##### ### # # ##### # ####### # ### ##### #
# #   #     # #     # # # #     #     #   #     #     #
# ##### ##### # ##### # # # ######### ########### ### #
#     #   #       #     # # #       # #     #   #   # #
##### ### # ####### ##### # ##### ### # ### # # ### # #
#   #   # #   #     # #   #     # #   #   #   #   # # #
# # ### # ##### ##### # ### ### # # ##### ####### # # #
# #     # #     #     # #     # # # #     #     #   # #
# ####### # ##### ##### ####### # # ### ### # ####### #
# #       # #     #     #       #   #   #   # #     # #
# # ####### # ##### ##### ####### ### ### # ### # ### #
# #         #     # #     #     #   # # # #     # #   #
# ######### ##### # # ####### # ### # # # ####### # ###
#         #     # # #       # # #   # #       #   #   #
# ####### ##### # # # ##### # ### ### ####### # # ### #
#     #   #   #   # #     # #     #   #   #   # #   # #
####### ### # ##### ##### # ### ### # # # ##### ##### #
#       #   #       #   # #   # # # # # #     #   #   #
# ##### # ########### # ##### # # # # # ##### # # # ###
#     # #     #       # #     # #   # #     # # # # # #
# ### ####### # ####### # ##### ### # ##### # ### # # #
# # #   #     # #   #   #     #   # #       #   #   # #
# # ### # ##### ### # ####### ### # ####### ### # ### #
# #   #   #     #   # #       #   #   #   #   # # #   #
# # ######### # # ### # ####### ####### # ##### # # # #
# #         # # #     #   #   # #       # #     # # # #
# ### ##### ### # ####### # ### # ####### # ##### ### #
#     #         #         #       #         #        T#
#######################################################
