#######################################################
#O#   #       #           #     #                 #   #
# # # # # ### ### ######### ### # # # ########### # # #
# # # # # #       #     #   # #   # # #   #   #   # # #
# ### # # ######### ### # ### ##### ### # # # ### ### #
#   # # # #           #           #     #   #   #     #
### # # # # ##################### ############# ##### #
#   #   #   #       #   #       #   #   #     #     # #
# ### ####### ##### # # # ##### ### # # # ### ##### ###
# #       #   #   #   #   # #   #     # # # #     #   #
# ####### # ### # ######### # ########### # ##### # # #
#   #     #     #   #       #       #     # #   # # # #
### # ############# ####### ####### # ##### # # # ### #
#   # #           #       #       # #     # # # # #   #
# ### ########### ####### # ### ### ##### # # # # # # #
# #   #   #     # #   #   #   # #   #     #   #   # # #
# # ### # # ### # # # # ### # ### ### ##### ####### ###
# #     #   # # # # #   # # #   # #   #   # #         #
# ########### # # # ##### # ### # # ### ### ######### #
# #   #   #       #   #       # #   # #     #   #     #
# # # # # ########### # ####### ##### # ##### # # ### #
#   #   #       #     # #     #         #   # #   # # #
############### # ####### ### ##### ##### # # ##### # #
#   #       #   #   #     # #     #       #   #       #
# # # ####### ### # # ##### ##### ############# #######
# #   #       #   # #     # #     #         #   #   # #
# ##### ########### ##### # # ### # ####### # ### # # #
# #   # #         #     #   # #   #     #   #     #   #
# # # # # # ##### # ##### ### # ##### ### ########### #
#   #   # #   #   #     # #   #   #   #   #       #   #
# ####### ### # ##### # # # ####### ### ### # ##### ###
# #     #   # # #   # #   # #       # # #   #   #   # #
# ##### ### # # # # # ##### # ####### # # ##### # ### #
#     #   # # # # # #     # #   #     # # #   # #   # #
##### # ### # # # # ##### # ### # # # # ### # # ### # #
#   # #     # # # # #     #     # # # # #   # #   # # #
# # # # ##### # # # ##### ######### ### # ### ### # # #
# #   #   #   #   #     #         # #   # # # #   # # #
# ######### ########### ### ##### # # ### # # # ### # #
# #   #     #         #   # #   #   #   # # #   #   # #
# # # # ##### ####### ### ### # ### ### # # # ### ### #
#   # #   # #   #       # #   # # #   # # #   #   #   #
##### ### # ### # ##### # # ### # # ### # ##### ### # #
#   #   # #   # # #     #   # # #   #   #   #   #   # #
# # ### # # # # # ########### # # ### ##### # ##### # #
# # #   # # # # #             # #   # #   # #     # # #
# ### ### # # # ####### ### ### ### # # # # ##### ### #
#     #   # #   #     # # # #   #   # # # #       #   #
# ##### ### ####### # # # # # ####### # # # ####### ###
#       # # #     # # # #   # #     # # # #   #   #   #
######### # # ### ### # ### # # ### # # # ### # # ### #
#       #   #   #     #   # # # # # #   #   #   #     #
# ####### ##### ##### ### ### # # # ####### ######### #
#               #       #       #           #        T#
#######################################################
