#######################################################
#O  #         #       #   #     #     #       # #     #
### # ####### # ##### # # # # # ### # # ### # # # # ###
# # #   #     #   # #   # # # #   # #   #   #   # #   #
# # # # # ####### # ##### ### ### ####### ####### ### #
#   # # # #       #     # #   # # #     #   #       # #
# ##### # # ####### ### # # ### # # ### ### # ####### #
#       # # #     # # #   #   # #   # # #   #   #     #
######### # # # ### # ##### # # ##### # # ##### # #####
# #     # # # #   # #   # # # # #     # #   #   #     #
# # ### # # # ### # # # # # # # # # ### # # # ####### #
#   #   #   #   #   # # #   # #   # #   # #   #       #
##### # ####### ##### # # ### ##### # ######### #######
#   # # #     #       # #   #     # # #       #       #
# # # # # ### ######### ######### # # ### ### ####### #
# #   # #   #     #     #     #   #       #   #     # #
# ##### # ### ### # ##### ### # ########### ### ### # #
#   #   # #   #   # #     # # #     #     # #     # # #
# # # ### # # ##### # ##### # ##### ### ### # ### # # #
# # #   # # # #   #   #   # #     #   #   # # #   #   #
# # ### # # ### # ##### # # ##### ### ### # # # ##### #
# # # # # #     # #     #     #   #   #   # # #   #   #
### # # ######### # ### ##### # ### ### # # ##### ### #
#   #       #   #     # #   # # #   #   # #     #   # #
# ######### # # ####### # # # # # ### ######### ### # #
#   #   # #   #         # # # # #   #         #     # #
# # # # # ############### # # # ### # ####### ####### #
# #   # #             #   #   #     #   #   #   #   # #
# ##### ##### ######### ################# # # # # # # #
#     #     # #       #           #   #   #   # # #   #
##### ##### # # ##### ########### # # # ### ##### #####
#   #     # #   #   #       #   # # #   #   #   # #   #
# # ##### # # ### # # ##### # ### # ##### ### # # ### #
# #   #   # # #   # #     #   #     #       # # #   # #
##### # ### # # ### ##### ##### ############# # ### # #
#     #   # # #   # #     #       #   #       #     # #
# # ##### # ##### # # ##### ####### # # ############# #
# # #     #       # #       #       #   #   #         #
# ### ############# # ####### ########### # # # ##### #
# #   #     #   #   #   #     #     #     #   #     # #
# # ### # # ### # ####### ####### ### ############# # #
#   #   # #     #     #   #     #       #       #   # #
# ####### ########### # ### ### ####### ##### ### #####
# #     #     #     # #   # # #     #         #   #   #
# # ### # ### # ### # ### # # ##### ######### # ### # #
#   # # #   #   #   #   #   #     #       #   #   # # #
##### # ### ##### # # ####### ########### ####### # # #
#       #     #   # #     # #       #   #       #   # #
# ########### # ### ### # # # ### # # # ####### ##### #
# #     #   # # # # # # #   # # # # # #   # #   #   # #
# # ### # # ### # # # # ##### # # ### # # # # ### # # #
# #   # # #   # # #   #       # # #   # #   # #   #   #
# ### # # ### # # ### ######### # # ### ##### ### ### #
#     #   #     #               #     #           #  T#
#######################################################
