+---+---+---+---+---+---+---+---+---+---+---+---+---+---+---+---+---+---+---+---+---+---+---+---+---+---+---+
| O |       |               |                       |           |                                   |       |
+   +   +   +   +   +---+   +---+   +---+---+---+---+   +---+   +   +   +   +---+---+---+---+---+   +   +   +
|   |   |   |   |   |               |           |       |   |       |   |   |       |       |       |   |   |
+   +---+   +   +   +---+---+---+---+   +---+   +   +---+   +---+---+   +---+   +   +   +   +---+   +---+   +
|       |   |   |   |                       |                       |           |       |       |           |
+---+   +   +   +   +   +---+---+---+---+---+---+---+---+---+---+   +---+---+---+---+---+---+   +---+---+   +
|       |       |       |               |       |               |       |       |           |           |   |
+   +---+   +---+---+---+   +---+---+   +   +   +   +---+---+   +---+   +   +   +   +---+   +---+---+   +---+
|   |               |       |       |       |       |   |       |           |   |   |   |           |       |
+   +---+---+---+   +   +---+   +   +---+---+---+---+   +   +---+---+---+---+---+   +   +---+---+   +   +   +
|       |           |           |       |               |               |           |   |       |   |   |   |
+---+   +   +---+---+---+---+---+---+   +---+---+---+   +---+---+---+   +   +---+---+   +   +   +   +---+   +
|       |   |                       |               |               |   |           |   |   |   |   |       |
+   +---+   +---+---+---+---+---+   +---+---+---+   +   +---+   +---+   +---+---+   +   +   +   +   +   +   +
|   |       |       |           |   |       |       |       |   |       |           |       |       |   |   |
+   +   +---+   +   +   +---+   +   +   +   +   +---+   +   +---+   +---+   +---+---+   +---+---+---+   +---+
|   |           |       |   |   |   |   |       |   |   |       |   |       |       |   |                   |
+   +---+---+---+---+---+   +   +   +   +---+---+   +   +---+   +   +   +---+   +---+   +---+---+---+---+   +
|   |       |       |               |       |               |   |       |   |           |       |           |
+   +   +   +   +   +---+---+---+---+---+   +   +---+---+---+   +---+---+   +   +---+---+   +   +   +---+   +
|       |       |               |           |   |           |                   |       |   |       |   |   |
+---+---+---+---+---+---+---+   +   +---+---+---+   +---+   +---+---+   +---+---+   +   +   +---+---+   +   +
|       |               |       |       |           |   |           |               |       |               |
+   +   +   +---+---+---+   +---+   +   +   +---+---+   +---+---+   +---+---+---+---+---+---+   +---+---+---+
|   |       |               |       |   |           |   |           |                   |       |       |   |
+   +---+---+   +---+---+---+---+---+   +---+---+   +   +   +---+   +   +---+---+---+   +   +---+   +   +   +
|   |       |   |                   |           |       |   |       |           |       |           |       |
+   +   +   +   +   +   +---+---+   +   +---+---+   +---+   +   +---+---+   +---+   +---+---+---+---+---+   +
|       |       |   |       |       |           |   |       |       |       |       |               |       |
+   +---+---+---+   +---+   +   +---+---+   +   +   +   +---+---+---+   +---+   +---+   +   +---+---+   +---+
|   |           |       |   |   |       |   |       |   |               |   |   |       |       |       |   |
+   +---+---+   +---+   +   +   +   +   +   +---+---+   +   +---+---+---+   +   +   +---+---+   +   +---+   +
|           |       |   |   |   |   |   |           |   |       |           |   |   |       |   |       |   |
+---+---+   +   +---+   +   +   +   +   +---+---+   +   +---+   +   +   +   +   +---+   +   +   +---+   +   +
|       |   |           |   |   |   |   |           |           |   |   |   |   |       |   |       |   |   |
+   +   +   +   +---+---+   +   +   +   +---+---+   +---+---+---+---+   +---+   +   +---+   +---+   +   +   +
|   |       |       |       |       |           |                   |   |       |   |   |   |       |   |   |
+   +---+---+---+---+   +---+---+---+---+---+   +---+   +---+---+   +   +   +---+   +   +   +   +---+   +   +
|   |       |           |                   |       |   |       |       |       |   |   |       |       |   |
+   +   +   +   +---+---+   +---+---+---+   +---+   +---+   +   +---+   +---+   +   +   +   +---+   +---+   +
|       |   |       |   |       |               |   |       |   |   |       |   |   |       |       |       |
+---+---+   +---+   +   +---+   +   +---+---+   +   +   +---+   +   +   +---+   +   +---+---+   +---+   +   +
|       |       |   |       |   |   |           |       |   |   |       |       |       |       |       |   |
+   +   +---+   +   +   +   +   +   +---+---+---+---+---+   +   +   +---+   +---+---+   +   +---+---+   +   +
|   |   |       |   |   |   |   |                           |   |       |   |       |   |           |   |   |
+   +---+   +---+   +   +   +   +---+---+---+   +---+   +---+   +---+   +   +   +   +   +---+---+   +---+   +
|           |       |   |       |           |   |   |   |       |       |   |   |   |               |       |
+   +---+---+   +---+   +---+---+---+   +   +   +   +   +   +---+---+---+   +   +   +   +---+---+---+   +---+
|               |   |   |           |   |   |   |       |   |           |   |   |   |       |       |       |
+---+---+---+---+   +   +   +---+   +---+   +   +---+   +   +   +---+   +   +   +   +---+   +   +   +---+   +
|               |       |       |           |       |   |   |   |   |   |       |       |       |           |
+   +---+---+---+   +---+---+   +---+---+   +---+   +---+   +   +   +   +---+---+---+   +---+---+---+---+   +
|                               |               |               |                       |                 T |
+---+---+---+---+---+---+---+---+---+---+---+---+---+---+---+---+---+---+---+---+---+---+---+---+---+---+---+
