+---+---+---+---+---+---+---+---+---+---+---+---+---+---+---+---+---+---+---+---+---+---+---+---+---+---+---+
| O     |                   |               |       |           |           |               |   |           |
+---+   +   +---+---+---+   +   +---+---+   +   +   +   +   +   +---+   +   +   +---+   +   +   +   +   +---+
|   |   |       |           |       |   |       |   |   |   |       |   |       |       |       |   |       |
+   +   +   +   +   +---+---+---+   +   +---+---+   +---+   +---+   +---+---+---+   +---+---+---+   +---+   +
|       |   |   |   |               |           |   |       |   |   |           |       |               |   |
+   +---+---+   +   +   +---+---+---+   +---+   +   +   +---+   +   +   +---+   +---+   +   +---+---+---+   +
|               |   |   |           |   |   |       |       |   |       |   |   |       |       |           |
+---+---+---+---+   +   +   +   +---+   +   +---+---+   +   +   +---+---+   +   +   +---+---+   +   +---+---+
|   |           |   |   |   |       |   |       |   |   |   |   |           |   |       |       |           |
+   +   +---+   +   +   +   +---+   +   +   +   +   +   +   +   +   +   +---+   +   +   +   +---+---+---+   +
|       |       |       |       |       |   |   |       |   |       |   |       |   |       |               |
+---+---+   +   +---+---+---+   +---+---+   +   +   +---+   +---+---+   +   +---+---+---+---+   +---+---+---+
|       |   |   |           |               |   |       |           |   |   |               |               |
+   +   +   +   +   +---+   +---+---+---+---+   +---+---+---+---+   +   +   +---+   +---+   +---+---+---+   +
|   |       |   |       |           |           |           |       |               |       |           |   |
+   +---+---+   +   +---+   +---+   +   +---+---+   +---+   +   +---+---+---+---+---+   +---+   +---+   +   +
|       |       |   |       |       |   |           |   |   |           |           |   |           |   |   |
+   +   +   +---+   +   +   +---+---+   +   +---+---+   +   +---+---+   +---+   +---+   +   +---+   +   +   +
|   |   |       |   |   |   |       |       |       |   |           |       |       |   |   |       |       |
+   +   +---+   +   +   +---+   +   +---+---+   +   +   +---+---+   +---+   +---+   +   +   +   +---+---+   +
|   |   |   |   |   |           |   |           |           |       |       |       |   |   |       |       |
+---+   +   +   +---+---+---+---+   +   +---+   +---+---+   +   +---+   +---+   +   +   +---+---+   +---+   +
|       |               |       |           |   |       |   |   |       |       |   |           |       |   |
+   +---+---+---+---+   +   +   +---+---+---+   +   +   +   +   +   +---+   +---+---+---+---+   +---+   +   +
|       |       |   |       |                   |   |   |   |   |       |                   |           |   |
+   +   +   +   +   +---+---+---+---+---+---+---+   +   +   +   +---+   +   +---+---+---+   +---+---+---+   +
|   |       |   |                           |       |       |           |       |       |       |       |   |
+   +---+---+   +---+---+   +---+---+---+---+   +---+---+---+---+---+---+---+---+   +   +   +   +   +   +   +
|           |           |   |               |                       |       |       |       |   |   |       |
+---+---+   +---+---+   +   +   +---+---+   +---+---+---+---+---+   +   +   +   +---+   +---+---+   +---+---+
|       |           |   |       |       |               |       |   |   |       |       |       |   |       |
+   +   +---+---+   +   +   +---+   +   +   +---+---+   +   +---+   +   +---+---+   +---+   +   +   +---+   +
|   |       |       |   |   |       |   |           |       |           |               |   |   |       |   |
+---+---+   +   +---+   +   +   +---+   +---+---+   +---+---+   +---+---+---+---+---+---+   +   +---+   +   +
|           |       |   |   |       |   |           |               |       |               |           |   |
+   +   +---+---+   +   +---+---+   +   +   +---+---+   +---+---+---+   +   +   +---+---+---+---+---+---+   +
|   |   |           |               |   |               |               |       |       |                   |
+   +---+   +---+---+---+---+---+---+   +   +---+---+---+   +---+---+---+---+---+   +   +   +   +---+---+   +
|   |       |           |       |       |       |           |           |           |       |           |   |
+   +   +---+   +   +   +---+   +   +---+---+---+   +---+---+---+   +---+   +---+---+---+---+---+---+   +   +
|       |       |   |           |           |       |           |               |               |       |   |
+   +---+---+---+   +---+---+---+---+---+   +   +---+   +---+   +---+---+---+   +---+---+   +---+   +---+---+
|   |           |           |           |   |       |   |   |           |                   |       |       |
+   +   +---+   +   +---+   +   +---+   +   +---+   +   +   +---+---+   +---+---+---+---+   +   +---+   +   +
|       |   |   |       |       |       |       |       |           |               |       |       |   |   |
+---+---+   +   +---+   +---+---+   +   +   +---+---+---+   +---+---+---+---+---+   +---+---+---+   +   +   +
|               |           |       |   |           |   |               |       |               |       |   |
+   +---+---+---+---+---+   +   +---+   +---+   +   +   +   +---+   +   +   +   +---+---+---+   +---+---+   +
|   |           |       |   |   |   |   |   |   |       |   |   |   |   |   |       |   |       |       |   |
+   +   +---+   +   +   +---+   +   +   +   +   +---+---+   +   +   +---+   +   +   +   +   +---+   +   +   +
|   |       |   |   |       |   |   |       |               |   |   |       |   |       |   |       |       |
+   +---+   +   +   +---+   +   +   +---+   +---+---+---+---+   +   +   +---+   +---+---+   +---+   +---+   +
|           |       |           |                               |           |                       |     T |
+---+---+---+---+---+---+---+---+---+---+---+---+---+---+---+---+---+---+---+---+---+---+---+---+---+---+---+
