+---+---+---+---+---+---+---+---+---+---+---+---+---+---+---+---+---+---+---+---+---+---+---+---+---+---+---+
| O                                 |           |           |                               |               |
+---+---+---+---+---+---+---+---+   +   +---+   +---+   +   +   +---+---+---+   +---+---+   +   +---+---+   +
|       |   |                   |   |       |           |   |   |               |       |       |           |
+   +   +   +   +---+   +   +---+   +---+   +---+---+---+   +   +   +---+---+---+   +   +---+---+   +---+---+
|   |       |   |   |   |   |       |       |       |       |   |   |               |   |       |   |       |
+   +---+---+   +   +   +   +   +---+   +---+---+   +   +---+   +---+   +---+---+---+   +---+   +   +---+   +
|   |           |   |   |   |           |           |   |       |               |       |       |   |       |
+   +   +---+---+   +   +---+---+---+---+   +---+---+   +   +   +   +---+---+---+   +---+   +---+   +   +   +
|       |           |       |               |           |   |   |   |           |   |           |   |   |   |
+   +---+   +---+   +---+   +   +   +---+   +   +---+---+   +---+   +   +---+   +   +   +---+   +   +   +---+
|           |   |   |   |       |   |       |           |   |       |   |   |       |   |   |       |       |
+---+---+---+   +   +   +---+---+   +   +---+---+---+   +   +   +---+   +   +---+---+   +   +---+---+---+   +
|       |           |       |       |   |   |       |   |       |       |       |       |           |       |
+---+   +   +---+---+---+   +   +---+   +   +   +   +   +   +---+   +---+   +---+   +---+---+   +   +   +---+
|       |   |       |       |       |   |   |   |       |       |       |                       |   |       |
+   +---+   +   +   +   +---+---+   +   +   +   +---+---+---+   +---+   +---+---+   +---+---+---+   +---+   +
|               |       |       |   |       |   |   |       |   |       |       |   |       |               |
+   +---+---+   +---+---+   +   +   +   +---+   +   +   +   +   +   +---+   +   +---+   +   +---+---+---+---+
|   |       |   |       |   |   |   |   |       |       |       |           |       |   |                   |
+   +   +   +---+   +   +   +   +   +   +   +---+---+---+---+   +---+---+---+---+   +   +---+---+---+---+   +
|   |   |           |   |   |       |   |   |               |               |       |   |                   |
+   +   +---+---+---+   +   +---+---+   +   +---+   +---+   +---+---+---+   +   +---+   +   +---+   +---+---+
|   |   |           |       |       |   |           |       |       |   |   |           |   |       |       |
+---+   +   +---+---+---+---+   +   +   +---+---+---+   +---+   +   +   +   +---+---+---+   +---+---+   +   +
|       |                       |   |       |   |       |       |   |               |       |           |   |
+   +---+   +---+---+   +---+---+   +---+   +   +   +---+---+   +   +---+---+---+   +   +---+   +---+---+   +
|   |       |           |   |           |   |   |   |           |           |       |           |           |
+   +---+---+   +---+---+   +   +---+---+   +   +   +   +---+---+---+---+   +---+---+---+---+---+   +---+   +
|           |       |               |           |   |   |               |   |           |       |       |   |
+---+---+   +---+   +   +---+---+---+   +---+---+   +   +---+---+   +---+   +   +---+   +   +   +---+   +   +
|       |       |   |       |           |   |       |           |   |       |       |       |       |   |   |
+   +   +---+   +   +---+---+   +---+---+   +   +---+   +---+   +   +   +---+---+   +---+---+---+   +   +   +
|   |           |   |           |           |   |           |   |   |   |           |           |       |   |
+   +---+---+---+   +   +---+---+   +---+---+   +---+---+---+   +   +   +---+   +---+   +   +---+---+---+   +
|   |               |   |           |           |               |       |       |       |   |           |   |
+   +   +---+---+---+   +   +---+---+   +---+---+   +---+---+---+   +---+   +---+   +   +---+   +   +---+   +
|   |                   |           |   |           |           |       |   |   |   |           |   |       |
+   +---+---+---+---+   +---+---+   +   +   +---+---+---+   +   +---+   +   +   +   +---+---+---+   +   +---+
|                   |           |   |   |               |   |   |       |   |               |       |       |
+   +---+---+---+   +---+---+   +   +   +   +---+---+   +   +---+   +---+   +---+---+---+   +   +   +---+   +
|           |       |       |       |   |           |   |           |       |       |       |   |       |   |
+---+---+---+   +---+   +   +---+---+   +---+---+   +   +---+   +---+   +   +   +   +---+---+   +---+---+   +
|               |       |               |       |   |       |   |   |   |   |   |           |       |       |
+   +---+---+   +   +---+---+---+---+---+   +   +---+---+   +   +   +   +   +   +---+---+   +   +   +   +---+
|           |   |           |               |   |           |   |       |   |           |   |   |   |   |   |
+   +---+   +---+---+---+   +   +---+---+---+   +   +---+---+   +---+   +   +---+---+   +   +---+   +   +   +
|   |   |       |           |   |       |       |           |       |   |               |       |       |   |
+   +   +---+   +   +---+---+   +---+   +   +---+---+---+   +---+   +   +---+---+---+   +---+   +   +---+   +
|   |       |       |           |       |   |               |       |       |       |       |   |   |       |
+   +   +---+---+---+---+   +   +   +---+   +   +---+---+---+   +---+---+---+   +   +---+---+   +   +   +   +
|   |                   |   |   |           |       |       |   |               |   |           |   |   |   |
+   +---+   +---+---+   +---+   +   +---+---+---+   +   +---+   +   +---+---+---+   +   +---+---+   +---+   +
|           |                   |                   |               |                   |                 T |
+---+---+---+---+---+---+---+---+---+---+---+---+---+---+---+---+---+---+---+---+---+---+---+---+---+---+---+
