+---+---+---+---+---+---+---+---+---+---+---+---+---+---+---+
| O         |           |                   |           |   |
+---+---+   +---+   +   +   +   +---+---+   +   +---+   +   +
|       |           |   |   |       |   |   |   |           |
+   +---+---+---+---+   +---+---+   +   +   +   +---+---+   +
|                   |           |   |       |           |   |
+   +   +---+---+   +---+---+   +   +   +---+---+---+   +   +
|   |       |           |       |   |       |           |   |
+   +---+   +---+---+---+   +---+   +---+   +   +---+---+   +
|   |   |       |       |   |           |       |           |
+   +   +---+   +   +   +   +   +---+   +---+---+---+---+   +
|   |       |       |   |   |       |                   |   |
+   +   +   +---+---+   +   +---+---+---+---+---+---+   +   +
|       |           |   |               |               |   |
+---+---+---+---+   +   +---+---+---+   +   +---+---+---+---+
|               |   |       |       |   |                   |
+   +---+---+   +   +---+   +   +   +   +---+---+---+---+   +
|           |   |       |       |       |               |   |
+---+---+   +---+---+   +---+---+---+---+   +---+---+   +   +
|       |       |       |           |   |       |           |
+   +   +   +   +   +---+   +---+   +   +   +   +---+---+---+
|   |   |   |   |           |   |   |       |               |
+   +   +---+   +---+---+---+   +   +---+---+   +---+---+   +
|   |               |           |           |       |       |
+   +   +---+---+   +   +   +---+---+---+   +---+---+   +   +
|   |   |       |   |   |           |       |           |   |
+   +---+   +   +---+   +---+   +   +   +---+   +---+---+---+
|       |   |       |   |       |   |       |               |
+   +   +   +---+   +   +   +---+---+---+   +---+---+---+   +
|   |           |       |                                 T |
+---+---+---+---+---+---+---+---+---+---+---+---+---+---+---+
