+---+---+---+---+---+---+---+---+---+---+---+---+---+---+---+
| O     |                           |                       |
+---+   +   +---+---+---+---+---+   +   +---+---+---+---+   +
|   |       |           |           |               |       |
+   +---+---+---+---+   +   +---+---+---+---+   +---+   +   +
|               |       |       |               |       |   |
+   +---+---+   +   +   +---+   +   +---+---+---+   +---+   +
|   |       |       |   |       |   |           |   |       |
+   +   +---+   +---+---+   +---+   +---+   +   +   +---+---+
|   |           |           |           |   |   |   |       |
+   +---+---+---+   +---+---+---+---+   +   +   +   +   +   +
|   |       |       |               |       |   |       |   |
+   +   +   +   +---+---+---+   +   +---+---+   +---+---+   +
|   |   |       |               |           |   |           |
+   +   +---+---+   +   +---+---+---+---+   +   +   +---+---+
|       |       |   |   |               |   |   |           |
+   +---+---+   +   +   +---+---+   +---+   +---+---+---+   +
|       |       |   |           |       |               |   |
+---+   +   +---+   +---+---+   +   +   +---+---+---+   +   +
|   |   |           |           |   |           |       |   |
+   +   +   +---+---+   +---+---+---+---+   +   +   +---+   +
|   |   |   |           |       |           |   |   |       |
+   +   +   +   +---+---+   +   +   +---+---+   +   +   +   +
|   |   |   |               |   |       |       |       |   |
+   +   +---+---+   +---+---+   +---+   +---+---+---+---+   +
|       |       |   |       |       |                   |   |
+   +---+   +   +---+   +   +---+   +   +---+   +---+---+   +
|       |   |           |       |   |       |           |   |
+---+   +   +---+---+---+---+   +   +---+   +---+---+   +   +
|           |                       |               |     T |
+---+---+---+---+---+---+---+---+---+---+---+---+---+---+---+
