###############################
#O#           #     #       # #
# ######### # ### # # ##### # #
#         # #   # # #     #   #
######### # ### # # ##### #####
#     # #   # # # #     #     #
### # # ##### # # ##### ##### #
#   # #   #   #   #   # #     #
# ### # # ### ####### # # ### #
#   # # #     #   #   #   # # #
# # # # ##### # # # ####### # #
# # #   #   #   #   #         #
### # ### # ### ##### #########
#   # #   # # # #     #     # #
# ##### ### # # # ##### ### # #
# #     #   #   # #     #   # #
# # ##### ### ### # # ##### # #
# # #   #   # #   # #     #   #
# # ### ### ### ######### ### #
# #   #   #     #         #   #
# ### # ######### ######### ###
#     #         # #   #     # #
# ####### ### # # # # # ##### #
#       # #   #   # # #     # #
####### ### ####### # ##### # #
# #     #   #       #   #   # #
# # ##### ### ### ####### ### #
# #   #   # # #   #     #     #
# ### # ### # # ### ### ##### #
#       #     #       #      T#
###############################
