###############################
#O    #     #         #     # #
##### ### # # # ##### # ### # #
#   #     # # #   # # # #     #
# ######### ##### # # # ##### #
#         #     # #   #     # #
# # ##### ##### # # ####### # #
# #   #     #   # #   #     # #
# ### ####### ### ### # ##### #
# # #   #   # #     #   #     #
# # ### # # # # ### ######### #
# #   #   # # #   #         # #
# # # ##### # ############# # #
#   #     # #       #       # #
######### # ####### # #########
#       # #   #   # #         #
# ##### # ### # # # ######### #
#     # #   #   #   #       # #
##### ##### ######### ##### # #
#   #   #   #     # #   #     #
# # # # # ### ### # # # #######
# # # # #     # # #   #       #
# # ### ####### # ##### ##### #
# #       #     #     #   #   #
# # ##### # # ####### ##### # #
# # #   # # #     #   #     # #
# ### # ### ### # # ### #######
#   # #   # #   # #   #       #
# # # ### # # ####### ####### #
# #     #   #                T#
###############################
