###############################
#S#         #   #   #     #   #
# # ### ### # # ### # # # # ###
# #   # #   # #     # # # #   #
# ##### ### # ####### # # # # #
#     #   # #   #     # # # # #
##### # # # # # # ##### # # # #
#     # # # # #       # # # # #
# ##### # # ####### ### # ### #
#   #   # # #     # #   #   # #
### # ### # # ### ### ##### # #
# # # #   #   #   #   #   #   #
# # # # ####### ### ### # ### #
# # # #   #   # #   # # #   # #
# # ### # ### # # ### # ### # #
# #   # #   # # #   # #   #   #
# ### # ### # # ### # ### #####
#   # #   # # #     # #   #   #
# # # ### # # ####### # ### ###
# #   #   # #       #   #     #
# ##### ### ##### # # ####### #
# #   #   #     # # # #   #   #
# # # ######### # ### # # # # #
# # #         # #       # # # #
# # ######### # ######### # ###
# # # #       # #       # #   #
# # # # ####### # ##### # ### #
#   #   #           #   #     #
##### ############### ####### #
#                     #      E#
###############################
