#############
#S  #       #
### ### ### #
# #     #   #
# ####### ###
#       #   #
# ### ##### #
# # #     # #
# # ##### # #
# #   # #   #
# # # # #####
#   #      E#
#############
