#############
#S  #       #
### # #######
#   #   #   #
# ##### # # #
# #   #   # #
# # # # ### #
#   # # #   #
##### # # # #
# #   # # # #
# # ##### # #
#         #E#
#############
