+---+---+
| O |   |
+   +   +
|     T |
+---+---+
