+---+---+---+---+---+---+---+---+---+---+---+---+---+---+---+---+---+
| O |           |       |   |               |                       |
+   +   +   +   +   +   +   +   +---+   +   +---+---+---+---+   +   +
|   |   |   |       |       |       |   |                   |   |   |
+   +---+   +---+---+---+   +---+   +   +---+---+---+---+   +   +---+
|       |       |           |       |   |       |       |   |       |
+---+   +---+   +   +---+---+   +---+   +   +   +   +   +   +---+   +
|       |       |           |   |   |       |   |   |       |       |
+   +---+   +---+   +---+---+   +   +---+---+   +   +---+---+   +---+
|   |       |       |       |   |       |   |   |   |               |
+   +   +---+---+---+   +   +   +   +   +   +   +   +---+---+   +   +
|   |               |   |       |   |       |   |           |   |   |
+   +---+---+---+   +   +---+---+   +---+---+   +---+---+   +---+   +
|   |           |               |   |       |       |       |       |
+   +   +---+   +---+---+---+   +   +   +   +---+   +   +---+   +   +
|       |   |       |           |       |       |   |           |   |
+---+---+   +---+   +   +---+---+---+---+   +---+   +---+---+---+   +
|           |       |       |       |       |       |       |       |
+---+---+   +   +---+---+   +   +   +   +   +   +---+   +   +---+---+
|           |       |   |       |       |   |       |   |           |
+   +---+   +---+   +   +   +---+---+---+   +---+   +   +---+---+   +
|   |           |   |       |           |       |               |   |
+   +   +---+---+   +   +---+   +---+   +---+---+---+---+---+---+   +
|   |   |       |   |       |       |                   |       |   |
+   +---+   +   +   +   +---+---+   +---+---+---+---+   +   +   +   +
|           |       |   |           |           |       |   |       |
+   +---+---+---+---+---+   +   +---+   +---+   +   +---+   +---+   +
|   |                       |   |       |       |       |   |       |
+   +---+---+---+---+   +---+   +   +---+   +---+---+   +   +---+---+
|       |       |       |       |       |   |           |           |
+---+   +   +   +   +---+---+---+---+   +   +   +---+---+---+---+   +
|   |       |   |                       |   |                   |   |
+   +---+---+   +---+---+---+---+---+---+   +---+---+---+---+   +   +
|                                           |                     T |
+---+---+---+---+---+---+---+---+---+---+---+---+---+---+---+---+---+
