+---+---+---+---+---+---+---+---+---+---+---+---+---+---+---+---+---+
| O |           |   |                                       |       |
+   +   +---+   +   +   +---+---+---+   +---+---+---+---+   +---+   +
|   |       |   |       |           |           |   |       |       |
+   +---+   +   +---+---+   +---+   +---+---+   +   +   +---+   +   +
|           |           |   |                   |       |       |   |
+---+---+---+---+---+   +   +---+---+---+---+---+   +---+---+   +   +
|   |                   |   |                   |               |   |
+   +   +---+---+---+---+   +   +---+---+---+   +---+---+---+---+   +
|       |           |           |           |           |           |
+   +---+---+   +   +   +---+---+   +---+   +---+---+   +---+---+   +
|       |       |   |   |       |   |       |           |       |   |
+---+   +   +---+   +   +   +   +---+   +   +   +---+---+   +   +---+
|   |   |   |       |       |           |   |   |           |       |
+   +   +   +   +---+---+---+   +---+---+---+   +   +---+---+---+   +
|   |       |               |   |               |           |       |
+   +---+---+---+---+---+   +---+   +   +---+---+   +---+---+   +   +
|       |               |       |   |   |           |           |   |
+   +   +   +   +   +---+---+   +   +   +   +---+---+   +---+---+   +
|   |       |   |   |       |   |   |   |   |       |           |   |
+   +---+---+   +   +   +   +   +   +---+   +   +   +---+---+   +---+
|           |   |   |   |   |   |   |       |   |           |       |
+---+---+   +   +---+   +   +   +   +   +---+---+   +---+---+---+   +
|   |       |       |   |       |       |       |   |           |   |
+   +   +---+---+   +   +---+---+---+   +   +   +   +   +---+   +   +
|               |   |               |       |   |       |       |   |
+   +---+---+---+   +---+---+---+   +---+---+   +---+---+   +---+   +
|       |       |               |   |   |       |           |       |
+---+---+   +   +---+   +---+   +   +   +   +---+   +---+   +   +   +
|           |           |       |   |               |       |   |   |
+   +---+---+   +---+---+---+---+   +---+---+---+---+---+---+   +   +
|       |       |               |           |               |   |   |
+   +   +---+---+   +---+---+   +---+---+   +   +---+---+   +   +   +
|   |                       |                   |               | T |
+---+---+---+---+---+---+---+---+---+---+---+---+---+---+---+---+---+
