###################################
#O#       #           # #         #
# # # # ### ### ##### # # ##### # #
# # # # #   # #   #     #   #   # #
# # # ### ### ### ######### # ### #
# # #   # #     # #         #   # #
# ##### # ##### # # ########### # #
#   #   # #     #   #   #       # #
### # ### # ######### # # ####### #
# # #     #     #     # # #   #   #
# # ### ####### # ##### # # # # ###
# #   #     #   # #   # #   # # # #
# ### ##### # ### # # # ##### # # #
#   #   #   #     # #     #   #   #
# # ### # ##### ### ####### ##### #
# #     #     # #   #     #     # #
# ########### ### # # ### # ### # #
#   #             # # #   #   # # #
### ################# # ####### # #
# #   #           #   # #     # # #
# ### # ######### # ### # ### # ###
#     #       #     #     # # #   #
# ##### ##### ############# # ### #
#   # #   #   #   #     #   #   # #
### # ### # ### # # ### # # ### # #
# # # #   #     #   # # # # # # # #
# # # # ########### # # # # # # # #
# # #   #     #   #   # # #   # # #
# # # ### ### # # ##### # ### # # #
# # # #   # # # #     # # #   # # #
# # ### ### # # ##### # # ##### # #
# #   # #     #     # # #       # #
# ### # # ######### # # # ####### #
#       #           #   #        T#
###################################
