+---+---+---+---+---+---+---+---+---+---+---+---+---+---+---+---+---+
| O |               |                       |   |                   |
+   +   +   +   +---+   +---+   +---+---+   +   +   +---+---+   +   +
|   |   |   |   |       |   |       |           |       |       |   |
+   +   +   +---+   +---+   +---+   +---+---+---+---+   +   +---+   +
|   |   |       |   |           |   |                   |       |   |
+   +---+---+   +   +---+---+   +   +   +---+---+---+---+---+   +   +
|       |       |   |           |       |       |               |   |
+---+   +   +---+   +   +---+---+---+---+   +   +   +---+---+---+   +
|   |   |           |           |           |   |   |       |       |
+   +   +---+   +---+---+---+   +   +---+---+   +   +   +   +   +---+
|   |       |           |       |   |       |   |       |   |   |   |
+   +---+   +---+---+   +   +---+   +   +   +   +---+---+   +   +   +
|       |       |       |           |   |           |       |       |
+   +   +---+   +   +---+---+   +---+   +---+---+---+   +---+---+   +
|   |           |           |   |       |           |           |   |
+   +---+---+---+---+---+   +---+   +   +   +---+   +   +---+   +   +
|       |                           |   |   |       |       |   |   |
+---+   +---+---+---+---+---+---+---+---+   +   +---+---+---+   +   +
|   |       |                       |       |   |           |   |   |
+   +---+   +   +---+---+---+---+   +   +---+   +   +---+   +   +---+
|           |               |           |           |   |   |       |
+   +---+---+   +---+---+   +---+---+---+---+---+---+   +   +---+   +
|       |   |       |       |       |           |       |       |   |
+---+   +   +---+   +   +---+   +   +   +---+   +   +   +---+   +   +
|   |   |   |       |           |       |   |   |   |   |   |   |   |
+   +   +   +   +---+---+---+---+---+   +   +   +   +   +   +   +   +
|   |   |       |           |       |       |   |   |       |   |   |
+   +   +   +---+   +---+   +   +   +---+---+   +   +---+   +   +   +
|   |   |   |       |   |   |   |           |   |   |       |   |   |
+   +   +---+   +---+   +   +   +---+---+   +   +   +---+---+   +   +
|   |       |   |           |           |   |   |               |   |
+   +---+   +   +   +---+---+---+---+   +   +   +   +---+---+---+   +
|               |                       |       |                 T |
+---+---+---+---+---+---+---+---+---+---+---+---+---+---+---+---+---+
