###################################
#O#     #   # #       #           #
# # # # # # # # ### # ######### # #
# # # #   #   #   # #         # # #
# ### ####### ### # ######### # ###
#   #   #     #   # #   #   # #   #
### ### # ##### ### # # # # # ### #
#   #   #     # # #   # # #   #   #
# ### ### ##### # ##### # ##### ###
# #   #   #   # #   # # # #       #
# # ####### # # # # # # # ##### # #
# #       # #   # #   # #     # # #
# ####### # ##### ##### ##### ### #
# #     #       # #   #   #   #   #
# # ### ####### # # # ### # ### # #
#   # #   #     #   #   # #     # #
##### ### # ######### ### ####### #
#     #   #   #   #   #   #   #   #
##### # ##### # # # # # ### # #####
#     #   # #   #   # #   # #     #
# ### ### # # ####### ### # ##### #
# #     # #   #     #   #       # #
# # ##### # ### ### ############# #
# # #   # #   #   #         #   # #
# ### # # # ##### ######### # # # #
#     #   # #     #     #   # #   #
# ########### # ### ### # ### ### #
# #           # #   #   #   # #   #
# ######### ### # ### ##### # #####
#   #   #   #   #   # #     #     #
### # # # ######### # # ######### #
# #   # #           # #         # #
# ##### ############# ######### # #
#                     #          T#
###################################
