###################################
#O#     # #                   #   #
# # ### # # ####### ######### ### #
# #   # #   #     #     # #   #   #
# ### # ##### ### ##### # # ### # #
#     #     # #         #   #   # #
########### # ########### ##### # #
# #         # #         #       # #
# # ######### # ####### ######### #
#   #     #     #     #     #     #
# ##### # # ##### ### ##### ##### #
#   #   # # #   # #   #     #   # #
### # ### # # # ### # # ##### # ###
# # # #   #   #     # # #     #   #
# # # # ####### ####### # ####### #
# #   #       # #       #     #   #
# ########### ### # ##### ##### # #
#   #       #   # # #     #     # #
# # # # # ##### # # # ##### ##### #
# #   # # #   # # # # #   #     # #
# ##### # # # # # ### # # ##### ###
#     # # # # # # #   # #     #   #
##### # ### # # # # ##### ####### #
# #   #   # #   #   #   # #     # #
# # ##### # ####### # # # # ### # #
#       # #       #   # #   #   # #
# ####### ####### ##### ##### ### #
#   #   #       # # #   #     #   #
##### # ### ### # # # ### ### # # #
#     #     #   # #       #   # # #
# ##### ######### ############# # #
#   #   #       #     #       # # #
# # ##### ##### ##### # ##### # # #
# #           #         #       #T#
###################################
