#############
#S  #       #
### ##### ###
# # #   #   #
# # # # # # #
# #   # # # #
# ##### ### #
# #   #   # #
# # # ### # #
# # #   #   #
# # ### ### #
#     #    E#
#############
