###########################################################
#O      #     #         #                       #   #     #
####### # ### # # ##### # # ################### # # # # # #
#       # #   # #     # # #     #   #       # # # # # # # #
# ####### # ##### ### # ####### # ### # ### # # # ### # ###
# #   #   # #   #   # #   #     #   # # #     # #     #   #
# # # ### # # # ##### ### # ##### # # # ####### ######### #
#   # #   # # #       #   # #   # #   #         #         #
##### # ### # ######### ### ### # ############### ####### #
#   #   # #   # #       #   #   # #       #       #       #
# # ##### ##### # ######### # ### # ##### # ####### #######
# #           #   #   #     #     # #   #   # #   #     # #
# ########### # ### # # # # ##### # # ####### # # ##### # #
# #     #     #   # # # # # #   #   #   #   #   #     # # #
# ### # # ####### # # # # ### # ##### # # # # ### ### # # #
# #   # #       #   # # # #   #     # #   # #   #   # #   #
# # ### ##### ####### ### # ####### # ##### ### ### # ### #
#   # # #   #   #   #   # # #   #   #     #   # # # #   # #
##### # # # ### # # ### # # # ### ######### ### # # ##### #
# #   # # #   #   # #   #   #   #         #       #     # #
# # # # # # ####### # ### ##### ######### ############# # #
#   #   # # #     #   # # #           # #       #       # #
# ####### ### # # ##### # ### ####### # ####### # ##### # #
# #     #   # # # #     #   #       # #     #   #   #   # #
# ### ### # # # # # ### ### # ##### # ### # # ##### ##### #
#   # #   # # # # # #   #   # #     # #   # # #     #     #
### # # ### # # ### # ### ##### ##### # # ### # ##### #####
#   #     # # #     # #         #   #   # #   #     # #   #
# ##### ### # ####### # ######### # ##### # ### ### # ### #
# #   # #   # #   #   #   #       #     # # # # #   #     #
# # # ### ### # ### # ### # ########### ### # # # ####### #
#   #   #   # # #   #   # # #     #   #     #   #       # #
####### ### # # # ####### # # ### ### ####### ##### ##### #
# #   # #   #   # #       # #   #   #       #     # #     #
# # # # # ### ### # ####### # # ### # ##### # ##### # #####
#   #   #     #   # #   #   # # #   # #   # # #     # #   #
# ####### ##### ### # # # ### # # ### # # ### # ### # ### #
#   #   # #   #     # #   #   # #     # #     #   # #     #
### # # # ### ##### # ######### # ##### ######### # ##### #
#   # #   #   #   # # #     #   # #     #   #     #   # # #
# ### ##### ### # ### # ### # ### # ##### # # ####### # # #
#   #   #   #   #   # #   # #   # #   #   # #     # #   # #
### ### # # # ##### # ### # ### # ### ##### ##### # # ### #
# # # #   # #   # #   #   #     #   #         #   #   #   #
# # # ### ##### # ##### ####### ########### ### ####### ###
# # #   # #   # #         #   # #   #     # #   #   #   # #
# # # # # # # # ######### # # # # # # # ### # ### # # ### #
#   # #   # #   #     #   # #   # #   # #   #   # #   #   #
# ######### ##### ### # ######### ##### # ##### # ####### #
#         #     # #   # #         #     # #   #   #       #
######### ##### # # ### # ######### ##### ### ##### ##### #
#     # #       # #     #       #   #   #     #       #   #
# ### # ######### ########### ### # # # ##### ### ### #####
#   #             #           #   # # # #   #   #   #     #
# # # ############# ########### ##### # # # ### ######### #
# # # #           # # #         #   # #   #   #     #   # #
# # ### ######### # # # ######### # # ####### ##### # # # #
# #             #     #           #         #         #  T#
###########################################################
