+---+---+---+---+---+---+---+---+---+---+---+---+---+---+---+---+---+---+---+---+---+---+---+---+---+---+---+---+---+
| O                 |           |                               |       |                                           |
+---+---+---+---+   +   +---+   +   +---+---+   +---+---+---+   +   +   +---+---+---+---+   +---+---+---+---+   +   +
|               |       |   |   |   |       |   |           |   |   |                   |   |   |           |   |   |
+---+   +---+---+---+---+   +   +   +   +   +   +---+---+   +   +   +---+---+---+---+   +   +   +   +---+   +   +   +
|       |           |       |   |   |   |   |           |   |   |   |           |       |   |   |   |   |   |   |   |
+   +---+   +   +   +   +   +   +   +   +---+---+---+   +   +   +   +   +---+   +   +---+   +   +   +   +   +---+   +
|           |   |   |   |   |   |       |               |   |       |   |       |       |       |   |   |           |
+---+---+---+   +   +   +   +   +---+---+   +---+---+---+   +---+---+   +---+---+---+   +---+   +   +   +---+---+   +
|       |       |   |   |   |   |           |   |                                   |   |   |   |   |           |   |
+   +   +   +---+   +   +   +   +   +---+---+   +   +---+---+---+---+---+---+---+   +   +   +   +   +   +   +---+   +
|   |       |   |       |   |   |   |           |   |           |               |   |   |   |   |   |   |   |       |
+   +---+---+   +   +---+---+   +   +   +---+   +   +   +   +   +   +---+---+---+   +   +   +   +   +   +---+   +---+
|           |       |           |   |   |       |   |   |   |       |           |       |       |   |           |   |
+---+---+   +---+---+   +---+---+   +   +   +---+   +---+   +---+---+   +---+   +   +---+---+   +   +---+   +---+   +
|           |           |           |   |       |   |       |       |   |   |   |           |   |       |           |
+   +---+   +   +---+---+   +---+---+---+   +   +   +   +---+   +   +   +   +   +---+---+   +---+---+   +---+---+   +
|   |   |   |       |       |           |   |       |       |   |           |       |   |       |       |       |   |
+   +   +   +---+   +   +---+   +---+   +   +---+---+---+   +   +---+---+---+---+   +   +---+   +   +---+   +---+   +
|   |           |   |           |       |       |           |   |                   |       |       |   |           |
+   +---+---+---+   +   +---+---+   +---+---+   +   +---+   +   +   +---+---+---+---+   +   +---+---+   +   +---+---+
|   |               |   |       |   |               |       |   |   |                   |   |           |   |       |
+   +   +---+---+---+---+   +   +   +---+---+---+---+---+---+   +   +---+---+   +---+---+   +   +---+   +   +   +   +
|       |       |           |   |   |       |           |       |           |   |       |       |       |   |   |   |
+   +---+   +   +   +---+---+   +   +   +   +   +---+   +   +---+---+---+   +   +   +   +---+---+   +---+   +   +---+
|           |   |       |       |   |   |       |       |   |       |   |   |       |   |       |       |   |       |
+---+---+---+   +---+   +   +---+   +   +---+---+   +   +   +   +   +   +   +---+---+---+   +   +---+   +   +   +   +
|   |       |           |   |   |       |   |       |   |   |   |       |   |               |       |       |   |   |
+   +   +   +---+---+---+   +   +   +---+   +   +---+---+   +   +---+   +   +   +---+---+---+---+   +   +---+---+   +
|       |                   |               |   |       |   |   |       |       |               |   |           |   |
+   +---+---+---+---+---+---+---+---+---+   +   +   +   +   +   +---+---+---+   +---+---+---+   +   +---+---+   +   +
|   |                               |       |   |   |           |           |           |       |   |               |
+   +---+---+---+---+---+---+   +   +---+---+   +   +---+---+---+   +---+   +---+---+   +   +---+   +   +---+---+---+
|       |               |       |   |       |       |           |   |   |           |   |       |   |   |           |
+---+   +   +---+---+   +   +---+   +   +   +---+---+   +---+   +   +   +---+---+   +   +---+   +   +---+   +---+   +
|   |       |       |   |   |   |       |           |   |           |           |   |       |   |   |           |   |
+   +---+---+---+   +   +   +   +---+---+---+---+   +   +---+---+---+---+---+   +   +---+   +   +   +   +---+---+   +
|   |               |       |       |               |   |       |               |   |   |       |       |       |   |
+   +   +   +---+---+---+---+   +---+   +---+---+---+   +   +   +   +   +---+   +   +   +---+   +---+---+   +   +   +
|   |   |       |           |           |       |       |   |   |   |       |   |   |       |   |           |       |
+   +   +---+   +   +   +   +   +---+---+   +   +   +---+   +   +---+---+   +   +   +   +---+   +   +---+---+---+   +
|   |       |       |   |   |       |       |   |           |           |   |   |   |   |       |           |       |
+   +---+   +---+---+   +---+---+   +   +---+   +   +---+---+---+---+   +   +---+   +   +   +---+---+---+   +---+---+
|   |       |       |               |   |   |   |   |           |       |           |       |           |           |
+   +   +---+   +   +---+---+---+---+   +   +   +   +   +---+---+   +---+   +---+---+   +---+   +---+   +---+---+   +
|   |       |   |                       |   |   |   |   |           |   |   |       |   |       |       |       |   |
+   +---+   +---+---+---+---+---+   +---+   +   +   +   +   +---+---+   +   +   +---+   +---+   +   +   +   +   +   +
|           |               |       |       |   |       |   |               |       |       |   |   |   |   |       |
+   +---+---+   +---+---+   +   +---+   +---+   +---+   +   +   +---+---+---+   +   +---+   +   +   +   +   +---+   +
|   |                   |       |               |       |   |       |           |           |   |   |   |       |   |
+   +---+   +---+---+   +---+---+---+   +---+---+---+---+   +---+   +---+---+   +---+---+---+---+   +---+---+   +   +
|       |   |       |   |           |                       |   |   |       |                   |   |           |   |
+---+   +   +   +   +   +   +---+   +---+---+---+---+---+---+   +   +   +   +---+---+---+---+   +   +   +---+---+---+
|       |   |   |   |           |                       |       |   |   |               |           |               |
+   +---+---+   +   +---+---+---+   +---+---+---+---+   +---+   +   +   +---+---+---+   +---+---+---+---+---+---+   +
|       |       |       |       |           |           |       |       |           |           |               |   |
+---+   +   +---+---+   +   +   +---+---+---+   +---+---+   +---+---+---+   +---+---+---+---+   +   +---+---+   +   +
|           |               |                   |                                                   |             T |
+---+---+---+---+---+---+---+---+---+---+---+---+---+---+---+---+---+---+---+---+---+---+---+---+---+---+---+---+---+
