+---+---+---+---+---+---+---+---+---+---+---+---+---+---+---+---+---+---+---+---+---+---+---+---+---+---+---+---+---+
| O             |           |                   |                                               |       |           |
+---+---+---+   +   +---+   +   +   +---+---+   +   +   +---+---+---+---+---+---+---+---+---+   +   +   +   +   +   +
|               |   |       |   |           |   |   |           |       |               |   |   |   |   |   |   |   |
+   +---+---+---+   +   +---+---+   +---+   +   +---+---+---+   +   +---+   +   +---+   +   +   +   +---+   +   +---+
|   |       |       |   |       |       |   |       |           |       |   |   |           |   |           |       |
+   +   +   +---+   +   +   +   +---+---+   +---+   +   +---+---+   +   +   +   +---+---+---+   +---+---+---+---+   +
|       |   |       |   |   |               |       |   |       |   |       |                   |                   |
+---+---+   +   +---+   +   +---+---+---+---+   +---+   +---+   +   +---+---+---+---+---+---+---+   +---+---+---+   +
|       |       |   |       |   |               |       |       |   |               |               |               |
+   +   +---+---+   +---+---+   +   +---+---+---+---+   +   +---+   +   +---+---+   +   +---+---+---+   +---+---+---+
|   |                       |       |       |           |           |   |       |       |   |       |           |   |
+   +---+---+---+---+---+   +   +---+   +   +   +   +   +---+---+   +   +   +---+---+---+   +   +   +---+---+   +   +
|   |           |           |       |   |   |   |   |   |       |       |       |       |       |           |   |   |
+   +---+   +   +   +---+---+---+   +   +   +   +   +---+   +   +---+---+   +   +   +   +   +---+   +---+   +   +   +
|   |       |   |               |       |   |   |   |       |           |   |       |   |       |       |   |       |
+   +   +---+   +---+---+   +---+---+---+   +---+   +   +---+---+---+   +   +---+---+   +---+   +---+   +   +---+   +
|       |   |   |       |       |       |       |   |   |       |       |           |       |   |   |   |       |   |
+---+---+   +   +   +   +---+   +   +   +---+   +   +   +   +---+   +---+---+---+---+   +---+   +   +   +---+---+   +
|   |       |   |   |       |       |   |       |       |       |                   |               |           |   |
+   +   +   +   +   +   +---+---+---+   +   +---+   +---+---+   +---+---+---+---+   +---+---+---+---+---+---+   +   +
|       |       |   |   |           |       |   |   |                       |   |               |               |   |
+   +---+---+---+   +---+   +   +   +---+---+   +   +---+   +---+---+---+   +   +---+---+---+   +   +---+---+   +   +
|   |           |       |   |   |   |           |       |               |   |           |       |       |       |   |
+   +---+   +---+   +   +   +   +   +   +---+   +---+   +   +---+---+   +   +---+   +   +   +---+---+   +---+---+   +
|       |   |       |   |   |   |   |   |       |       |   |           |   |       |   |   |           |           |
+---+   +   +   +---+   +   +   +---+   +   +---+   +---+---+   +---+---+   +   +   +---+   +   +---+---+   +---+---+
|       |           |   |   |           |   |                   |       |       |   |       |           |   |       |
+   +---+---+   +---+   +   +---+---+---+   +   +---+---+---+---+   +   +---+---+   +   +---+   +---+   +   +---+   +
|   |       |   |       |   |       |       |       |               |           |   |   |   |   |       |           |
+   +   +   +---+   +---+   +   +---+   +   +---+   +   +---+---+---+---+---+   +---+   +   +   +   +---+---+---+   +
|       |       |       |   |   |       |       |   |   |           |       |           |       |               |   |
+---+---+---+   +---+   +   +   +   +---+---+---+   +   +   +---+   +---+   +---+---+---+   +---+---+   +---+---+   +
|   |       |   |       |       |   |               |   |       |       |               |           |   |           |
+   +   +   +   +   +---+   +---+   +   +---+---+---+   +   +   +---+   +   +---+---+   +   +---+---+   +   +---+---+
|       |       |           |       |   |       |       |   |   |       |   |       |   |   |           |   |       |
+   +---+---+---+   +---+---+   +---+   +   +   +   +---+   +   +   +---+   +   +   +---+   +   +---+   +   +---+   +
|       |       |   |       |           |   |       |       |   |           |   |           |       |   |           |
+---+   +   +   +   +---+   +---+---+   +   +---+---+---+---+   +   +---+---+   +---+---+---+---+   +   +---+---+   +
|       |   |       |       |       |   |   |           |       |   |           |       |           |       |   |   |
+   +---+   +---+---+   +---+   +   +---+   +   +---+   +   +---+   +   +---+---+   +   +   +---+---+---+   +   +   +
|       |       |       |       |       |   |       |   |       |   |       |       |   |           |   |       |   |
+---+   +---+   +   +   +   +---+---+   +   +---+   +   +---+   +   +---+   +---+---+   +---+---+   +   +   +---+   +
|   |   |   |       |   |       |   |       |       |           |       |                   |       |       |       |
+   +   +   +---+   +---+---+   +   +---+---+   +---+---+---+   +---+---+---+---+---+   +---+   +---+---+---+   +---+
|   |   |       |   |       |   |                   |       |   |       |           |   |       |       |       |   |
+   +   +   +   +   +   +   +   +---+---+---+---+   +   +   +   +   +   +   +   +---+   +   +---+   +   +   +---+   +
|       |   |       |   |       |           |       |   |       |   |       |   |       |       |   |       |       |
+   +---+---+---+---+   +---+---+   +---+   +   +---+---+---+---+   +---+---+   +   +---+---+   +   +---+---+---+   +
|                   |           |   |       |   |                   |           |   |       |       |               |
+---+---+---+---+   +---+---+   +   +   +---+   +   +---+---+---+---+   +---+---+   +---+   +---+---+   +---+---+   +
|           |   |               |   |           |               |       |       |           |               |       |
+   +---+   +   +---+---+---+---+   +---+---+---+---+---+   +---+   +   +   +   +---+---+   +---+   +---+   +---+---+
|       |                           |                       |       |   |   |   |       |       |       |           |
+   +   +   +---+---+---+---+---+---+   +---+---+---+---+---+   +---+---+   +   +   +   +---+   +---+---+---+---+   +
|   |   |   |                       |   |   |                   |       |   |       |       |           |       |   |
+   +   +---+   +---+---+---+---+   +   +   +   +---+---+---+---+   +   +   +---+---+---+   +---+---+   +   +   +   +
|   |                           |           |                       |                   |                   |     T |
+---+---+---+---+---+---+---+---+---+---+---+---+---+---+---+---+---+---+---+---+---+---+---+---+---+---+---+---+---+
