###########################################################
#O#       #             #   #         #           #       #
# ### ### # ### ######### # # ### ### ### ####### # ### ###
#   #   #   #   #       # #   # #   # #   # #   # # # #   #
### ####### # ### ##### # ##### ### # # ### # # # # # ### #
# #       # #     # #   # #       # # #   #   #   #     # #
# ####### # ####### # # # # ##### # # # # ######### ##### #
#         # #       # # # # #     # # # #     #     #   # #
# ######### ##### ### ### # # ##### # ####### # ##### # # #
#     #   #       #   #   # # #     #   #   #       # #   #
##### # # ### ##### # # ##### # ####### # # ####### # ### #
#   # # #   # #     # #       # #     # # #   #     # #   #
### # ### ### # ############# # # # ### # ### ##### # # ###
#   # #   #   #   #         # # # #     #   # #   # # # # #
# ### # ### ##### # ##### # # # ####### # # # # # ### # # #
#     #     #   # #   #   # # #       # # # #   # #   #   #
# ##### ####### # ### # # ### ####### # ### ##### # ##### #
#     # #       #     # # #   #   #   # #   # #   #   #   #
##### # ### ########### ### ##### # ### # ### # ### # # ###
#     #   # #         #           # #     #   # #   # #   #
# ####### # # ####### # ######### # ######### # # ### #####
# #     #   #   #   # # #       # #   #       # #   #     #
# ### # ### ### # # # ### ##### # ### # ##### # ### ##### #
#   # #   #   #   # #   #   #   # #   #   #   # #   #   # #
### # ### ### ##### ### ### # ##### ##### # ### ### # # # #
#   # # #     #     # #     #     #     # #   #   # # # # #
# ### # ####### ##### ########### # ### # ####### ### # # #
# #   #   #   #   #       #     # #   # # #     # #   # # #
# ### # # ### ### ### ##### ### # ##### # # # # # # ### # #
#   #   #   #   #   #     #   #   #     #   # # # # # #   #
### ####### # ##### # ### ### ##### ##### ### ### # # ### #
# # #     # #     # # #   # #     # #       #     # #     #
# # ### ### # # # # ### # # ##### # ####### ####### # #####
# #   # #   # # # # #   #   #     #     #   # #     # #   #
# ### # # ### # ### # ##### # ######### # ### # # ### ### #
#   # # # #   # #   #   #   #         # # #     # #   #   #
# ### # # # ### # ##### # ########### # # ####### ### # # #
#   # # # #   # #     # # #   #       # #   #   #   #   # #
### # # # ##### ##### # # # # # ####### ### # # ### ##### #
#   # # #       #     # # # # # #       # # # #     # #   #
# ### # ##### ### ##### ### # # # ####### # # ####### # ###
#     #   #   #   #     #   # #   # #     #   # #       # #
# ##### # # ### ### # ### ### ##### # # ####### # ####### #
#   # # #     #   # # #   # #         #         # #     # #
### # # ######### # ### ### ################# # # ### # # #
#   # # #     #   #     #       #             # #     #   #
# ### # # ### # ### ######### # # ############# ######### #
#   #   # #     # # #         # # #     #       #       # #
### ##### ####### # # ##### ##### # # ### ####### ##### # #
# #   #   #     #   #   #   #     # # #   #     # # #   # #
# ### # ### ### ### ### # ### ##### ### ### ### # # # ### #
#     #       #   #     # # # # #       #   # #   # #   # #
# ##### ######### ####### # # # # ####### ### ##### ### # #
# #         #     #     #   # #         #       #     # # #
# ### ####### ##### ### ### # ################# ##### # # #
#   # #       #   # #   #   # #     #   #     #   #   # # #
### ### ####### ### # ### ### # ### # # # # ##### # # # # #
#       #           #       #     #   #   #         # #  T#
###########################################################
