###########################################################
#O        #     #               #   #                     #
######### # ### # ##### ####### # # ######### ######### # #
#       #   # # # #   # #     # # #         # # #     # # #
### ######### # # # # # ##### # # ######### # # # ### # # #
#   #     #   # # # # #     # # # #     #   # # # # # # # #
# ### # # # # # # # ####### # # # # ### # ### # # # # ### #
#     # # # # # #   #       # #   # #   #   #   # # #     #
####### # # # # ##### ####### ##### ####### ### # # ##### #
#   #   # # # # #     # #                 # # # # #     # #
# # # ### # # # # ##### # ############### # # # # # # ### #
# #   # #   # # # #     # #     #       # # # # # # # #   #
# ##### # ##### # # ### # # # # # ####### # # # # # ### ###
#     #   #     # # #   # # # #   #     #   #   # #     # #
##### ##### ##### # # ### ### ##### ### # ##### # ### ### #
#     #     #     # #   # #   #   # # # #     # #   #     #
# ### # ##### ####### # # # ### # # # # ##### ##### ##### #
# # # #   #   #     # #   #   # #     #   # #   #   #   # #
# # # ### # ### ### # ####### # ######### # ### # ### ### #
# #     # #     #   #   #     # #         #   #   # #     #
# ####### # ##### ##### # ### # # ######### # ##### # #####
# #       # #   # #       #   # # #         # #     # #   #
# # ######### # # ############# # ##### ##### # ### # # # #
#   #   #     # # #   #     #   #     # #   #   #   # # # #
# ### # # ##### # # # # ### # ####### # # # ##### ### # ###
#     # #   #   # # #   #   # #   # # #   # #   #   # #   #
####### ### # ### # ##### # # # # # # ####### # ### # # # #
# #   #     # # #   # #   # # # #   # #       #   #   # # #
# # # ####### # # ### # ##### # ### # # ######### # ##### #
#   #         #       # #   # # #   #   #       # #     # #
# ################### # # # # # ####### ####### # ##### # #
# #               #   # # #     #     #     #   # #       #
# ############# # ##### # ####### ### ##### # ### # #######
#   #       #   # #   #   #     # # #     # #   # # #     #
### # ##### # ### # # ##### ### # # ##### # ### # ### ### #
# #   #   # # # #   #     # #     #     # #   # # #     # #
# ####### # # # ######### # ########### # ### # # # ##### #
# #       #   #   #       # #   #       # # #   #   #   # #
# # # ######### ### ####### # # # # ### # # ### ##### # # #
# # #   #     #     #   #   # # # #   # # #   # #     #   #
# # ### # # # # ##### # # ### # ##### # # # ### # ####### #
# #   #   # # #   #   # #     #     # # # # #   #     #   #
# ### ##### ##### # ### # ######### # ### # # ####### #####
# #   #   #       # # # # #     #   #     #   #     #     #
# # ### # ######### # # # # ##### ### ##### ### ### ##### #
# #   # #           # # # # #     # # #   # #   #   #   # #
# ### ########### ### # # # # ##### # # ### ### # # # # # #
#     #       #   #   # #   # #       #   #   # # # # #   #
# ##### ##### # ### ### ### # # ####### # ### # # # # ### #
# #         #   #       #   # #   #     #     # # # #   # #
# ### ##### ####### ######### ### ##### ######### ##### # #
#   # #   # #     #           # # #   #         # #     # #
### # # # # # ### ############# # # # ######### # # #######
#   # # # #     #           #   # # #       #     #       #
# ##### # ####### ######### ### # # ####### ############# #
#   #   #   #   #     #     #   #   #     #     #       # #
### # ##### # # ####### ##### ####### ######### # ##### # #
#     #       #         #                         #      T#
###########################################################
