###############################
#S          #                 #
########### ### # ########### #
# #     #   #   # #     # #   #
# # ### # ### ##### ### # # ###
# # # #   #   #       # # #   #
# # # ##### ### ####### # ### #
# # #     # #     #     # #   #
# # # ### # # ##### ##### # ###
# #   #   #   #   # #     #   #
# ##### ### ### # # # # ##### #
#       # # # # #   # # #     #
# ####### # # # ##### ### #####
# #     #   # #   # #     #   #
# ##### # ### ### # # ####### #
#     # # #     # #         # #
##### # # # ### # ######### # #
#   # #   #   # #     #   #   #
# ### ### ##### ##### ### ### #
#   #   #     #     #   #     #
### ### ##### # ### ### ##### #
#   # # #       # #   #     # #
# # # # ######### ### ##### # #
# #   #     #       #     # # #
# ### ##### # ##### ##### # # #
# # # #   # #     #     # # # #
# # # ### # ######### # # # ###
# #       #     #   # #   #   #
# ############# # # ######### #
#                 #          E#
###############################
