+-+-+-+-+-+-+-+-+-+-+-+-+-+-+-+
|S          |                 |
+-+-+-+-+-+ +-+ + +-+-+-+-+-+ +
| |     |   |   | |     | |   |
+ + +-+ + +-+ +-+-+ +-+ + + +-+
| | | |   |   |       | | |   |
+ + + +-+-+ +-+ +-+-+-+ + +-+ +
| | |     | |     |     | |   |
+ + + +-+ + + +-+-+ +-+-+ + +-+
| |   |   |   |   | |     |   |
+ +-+-+ +-+ +-+ + + + + +-+-+ +
|       | | | | |   | | |     |
+ +-+-+-+ + + + +-+-+ +-+ +-+-+
| |     |   | |   | |     |   |
+ +-+-+ + +-+ +-+ + + +-+-+-+ +
|     | | |     | |         | |
+-+-+ + + + +-+ + +-+-+-+-+ + +
|   | |   |   | |     |   |   |
+ +-+ +-+ +-+-+ +-+-+ +-+ +-+ +
|   |   |     |     |   |     |
+-+ +-+ +-+-+ + +-+ +-+ +-+-+ +
|   | | |       | |   |     | |
+ + + + +-+-+-+-+ +-+ +-+-+ + +
| |   |     |       |     | | |
+ +-+ +-+-+ + +-+-+ +-+-+ + + +
| | | |   | |     |     | | | |
+ + + +-+ + +-+-+-+-+ + + + +-+
| |       |     |   | |   |   |
+ +-+-+-+-+-+-+ + + +-+-+-+-+ +
|                 |          E|
+-+-+-+-+-+-+-+-+-+-+-+-+-+-+-+
