+---+---+---+---+---+
| O |               |
+   +---+---+   +   +
|   |           |   |
+   +   +---+---+   +
|   |       |   |   |
+   +---+   +   +   +
|           |       |
+---+---+---+   +---+
|                 T |
+---+---+---+---+---+
