###############################
#S  #   #         #           #
### # # ##### ### # ####### ###
# #   #     #   #         #   #
# ######### # ############### #
#         # # #         #   # #
# ### ### # ### ####### # # # #
#   # # # #     # #     # #   #
### # # # ####### # ##### ### #
#   # # # #     #   #     # # #
# ### # # # ### # ##### ### # #
# #   # # # #   # #     #   # #
### ### # # # ### # ##### ### #
#   #   # # # #   # #   #     #
# ### # # # ### ### # ### #####
#   # #   #   #     #     #   #
### # ####### ####### ##### # #
#   #       #     #   #   # # #
# # ####### ### ### ### # # # #
# # #   #     # #   #   #   # #
# ### # ##### # # ### # ##### #
#     # #   #   #   # # #   # #
# ##### # # ### ### ### # ### #
#     #   #   #   #     #   # #
##### ####### ############# # #
#   #     # #               # #
# # ##### # ######### ####### #
# #     #   #   #   # #   #   #
# ######### # # ### # # # # ###
#             #     #   #    E#
###############################
