#############
#S  # #     #
### # # ### #
# # #     # #
# # ####### #
#   #     # #
# ### ### # #
# #   # #   #
# ### # ### #
#     #     #
####### #####
#          E#
#############
